,Mat,Inns,Dis,Ct,St,Ct Wk,Ct Fi,MD,D/I,start,end,name,country
0,98,97,91,57,34,57,0,5 (5ct 0st),0.938,2006,2019,MS Dhoni ,INDIA
1,78,78,72,65,7,21,44,4 (4ct 0st),0.9229999999999999,2006,2017,AB de Villiers ,SA
2,71,71,63,43,20,43,0,4 (4ct 0st),0.887,2006,2019,D Ramdin ,WI
3,58,58,60,28,32,28,0,4 (0ct 4st),1.034,2006,2017,Kamran Akmal ,PAK
4,84,82,59,31,28,30,1,3 (1ct 2st),0.7190000000000001,2006,2019,Mushfiqur Rahim ,BDESH
5,65,65,54,26,28,26,0,5 (3ct 2st),0.83,2010,2018,Mohammad Shahzad ,AFG
6,72,72,52,51,1,1,50,4 (4ct 0st),0.722,2010,2019,DA Miller ,SA
7,84,84,52,50,2,11,39,3 (3ct 0st),0.619,2009,2019,Umar Akmal ,PAK
8,111,111,50,50,0,0,50,3 (3ct 0st),0.45,2006,2019,Shoaib Malik ,PAK
9,38,38,46,36,10,36,0,4 (3ct 1st),1.21,2012,2019,Q de Kock ,SA
10,83,82,46,46,0,0,46,3 (3ct 0st),0.56,2009,2019,MJ Guptill ,NZ
11,78,76,46,39,7,28,11,4 (3ct 1st),0.605,2008,2019,GC Wilson ,IRE
12,56,56,45,25,20,25,0,3 (2ct 1st),0.8029999999999999,2006,2014,KC Sangakkara ,SL
13,58,58,45,35,10,35,0,3 (3ct 0st),0.775,2010,2019,Sarfaraz Ahmed ,PAK
14,71,71,44,36,8,24,12,3 (3ct 0st),0.619,2005,2015,BB McCullum ,NZ
15,95,95,44,44,0,0,44,3 (3ct 0st),0.46299999999999997,2006,2019,LRPL Taylor ,NZ
16,76,76,43,43,0,0,43,3 (3ct 0st),0.565,2009,2019,DA Warner ,AUS
17,78,78,42,42,0,0,42,3 (3ct 0st),0.5379999999999999,2006,2018,SK Raina ,INDIA
18,75,75,41,41,0,0,41,3 (3ct 0st),0.546,2010,2019,Mohammad Nabi ,AFG
19,104,104,38,38,0,0,38,3 (3ct 0st),0.365,2007,2019,RG Sharma ,INDIA
20,54,54,37,32,5,15,17,4 (4ct 0st),0.685,2010,2018,LD Chandimal ,SL
21,75,75,37,37,0,0,37,3 (3ct 0st),0.493,2010,2019,V Kohli ,INDIA
22,86,86,37,37,0,0,37,3 (3ct 0st),0.43,2009,2019,EJG Morgan ,ENG
23,73,70,36,36,0,0,36,3 (3ct 0st),0.514,2010,2019,GH Dockrell ,IRE
24,66,66,35,35,0,0,35,3 (3ct 0st),0.53,2006,2016,DJ Bravo ,WI
25,81,81,35,35,0,0,35,2 (2ct 0st),0.43200000000000005,2007,2019,JP Duminy ,SA
26,90,86,34,34,0,0,34,2 (2ct 0st),0.395,2008,2019,KJ O'Brien ,IRE
27,68,68,34,34,0,0,34,2 (2ct 0st),0.5,2008,2019,KA Pollard ,WI
28,43,41,33,22,11,22,0,3 (2ct 1st),0.804,2013,2019,MH Cross ,SCOT
29,80,80,33,31,2,5,26,2 (2ct 0st),0.41200000000000003,2006,2016,TM Dilshan ,SL
30,60,59,32,32,0,0,32,2 (2ct 0st),0.542,2011,2019,AD Hales ,ENG
31,51,50,31,31,0,0,31,2 (2ct 0st),0.62,2013,2019,BN Cooper ,NL
32,83,81,31,31,0,0,31,2 (2ct 0st),0.382,2007,2019,Mahmudullah ,BDESH
33,68,68,31,31,0,0,31,4 (4ct 0st),0.455,2007,2017,DJG Sammy ,WI
34,34,34,30,30,0,8,22,2 (2ct 0st),0.882,2011,2019,JM Bairstow ,ENG
35,61,60,30,30,0,0,30,2 (2ct 0st),0.5,2012,2019,GJ Maxwell ,AUS
36,79,79,30,30,0,0,30,2 (2ct 0st),0.379,2010,2019,NLTC Perera ,SL
37,33,33,30,24,6,24,0,3 (3ct 0st),0.909,2008,2018,L Ronchi ,AUS
38,99,99,30,30,0,0,30,3 (3ct 0st),0.303,2006,2018,Shahid Afridi ,PAK
39,66,65,29,29,0,0,29,2 (2ct 0st),0.446,2008,2019,TG Southee ,NZ
40,43,41,28,28,0,0,28,4 (4ct 0st),0.682,2008,2017,PW Borren ,NL
41,29,28,28,24,4,24,0,3 (3ct 0st),1.0,2018,2019,SA Edwards ,NL
42,69,67,28,28,0,0,28,2 (2ct 0st),0.41700000000000004,2008,2019,PM Seelaar ,NL
43,42,40,27,26,1,26,0,4 (4ct 0st),0.675,2012,2019,W Barresi ,NL
44,66,65,27,23,4,21,2,3 (3ct 0st),0.415,2011,2018,JC Buttler ,ENG
45,49,49,27,27,0,0,27,4 (4ct 0st),0.551,2009,2019,CS MacLeod ,SCOT
46,57,57,27,27,0,0,27,2 (2ct 0st),0.473,2012,2019,Najibullah Zadran ,AFG
47,30,28,27,17,10,15,2,4 (3ct 1st),0.9640000000000001,2008,2016,NJ O'Brien ,IRE
48,57,56,27,27,0,0,27,3 (3ct 0st),0.48200000000000004,2011,2019,KS Williamson ,NZ
49,63,63,26,26,0,0,26,3 (3ct 0st),0.41200000000000003,2007,2016,NL McCullum ,NZ
50,66,66,25,25,0,0,25,3 (3ct 0st),0.37799999999999995,2006,2019,H Masakadza ,ZIM
51,89,89,25,25,0,0,25,2 (2ct 0st),0.28,2006,2018,Mohammad Hafeez ,PAK
52,44,43,25,25,0,0,25,3 (3ct 0st),0.581,2014,2019,Sabbir Rahman ,BDESH
53,58,57,24,24,0,0,24,3 (3ct 0st),0.42100000000000004,2011,2019,AJ Finch ,AUS
54,39,39,24,24,0,0,24,2 (2ct 0st),0.615,2008,2012,DJ Hussey ,AUS
55,34,34,23,17,6,17,0,3 (3ct 0st),0.6759999999999999,2006,2014,BJ Haddin ,AUS
56,43,43,23,23,0,0,23,3 (3ct 0st),0.534,2014,2019,CJ Jordan ,ENG
57,72,72,23,23,0,0,23,2 (2ct 0st),0.319,2009,2018,AD Mathews ,SL
58,40,40,23,23,0,0,23,2 (2ct 0st),0.575,2016,2019,HH Pandya ,INDIA
59,46,45,23,23,0,0,23,2 (2ct 0st),0.511,2015,2019,Soumya Sarkar ,BDESH
60,41,39,23,23,0,0,23,3 (3ct 0st),0.589,2014,2019,SR Thompson ,IRE
61,47,47,23,23,0,0,23,2 (2ct 0st),0.489,2007,2014,CL White ,AUS
62,25,24,22,13,9,13,0,3 (1ct 2st),0.9159999999999999,2018,2019,AT Carey ,AUS
63,42,42,22,21,1,10,11,3 (2ct 1st),0.523,2008,2018,ADS Fletcher ,WI
64,61,59,22,22,0,0,22,2 (2ct 0st),0.37200000000000005,2008,2018,WTS Porterfield ,IRE
65,72,71,22,22,0,0,22,3 (3ct 0st),0.309,2009,2019,PR Stirling ,IRE
66,56,56,21,21,0,0,21,3 (3ct 0st),0.375,2006,2014,SCJ Broad ,ENG
67,44,44,21,21,0,0,21,2 (2ct 0st),0.47700000000000004,2012,2019,F du Plessis ,SA
68,36,36,21,21,0,0,21,3 (3ct 0st),0.583,2010,2019,SPD Smith ,AUS
69,66,66,20,20,0,0,20,2 (2ct 0st),0.303,2010,2019,Asghar Afghan ,AFG
70,38,38,20,20,0,0,20,3 (3ct 0st),0.526,2005,2012,MEK Hussey ,AUS
71,46,46,20,20,0,0,20,2 (2ct 0st),0.434,2009,2019,RA Jadeja ,INDIA
72,25,25,20,17,3,17,0,3 (2ct 1st),0.8,2010,2012,C Kieswetter ,ENG
73,79,79,20,20,0,0,20,2 (2ct 0st),0.253,2006,2019,SL Malinga ,SL
74,35,35,20,20,0,0,20,2 (2ct 0st),0.5710000000000001,2007,2019,CO Obuya ,KENYA
75,26,26,20,20,0,0,20,4 (4ct 0st),0.769,2015,2019,L Siaka ,PNG
76,49,49,20,20,0,1,19,3 (3ct 0st),0.408,2007,2019,LMP Simmons ,WI
77,58,58,20,20,0,0,20,2 (2ct 0st),0.344,2006,2016,SR Watson ,AUS
78,44,44,19,19,0,0,19,2 (2ct 0st),0.431,2009,2018,HM Amla ,SA
79,31,31,19,19,0,0,19,4 (4ct 0st),0.612,2012,2018,CJ Anderson ,NZ
80,25,25,19,18,1,18,0,3 (3ct 0st),0.76,2005,2010,MV Boucher ,SA
81,41,41,19,19,0,0,19,2 (2ct 0st),0.46299999999999997,2011,2019,CR Brathwaite ,WI
82,54,54,19,19,0,0,19,2 (2ct 0st),0.35100000000000003,2006,2019,E Chigumbura ,ZIM
83,58,56,19,19,0,0,19,2 (2ct 0st),0.33899999999999997,2008,2019,KJ Coetzer ,SCOT
84,32,31,19,14,5,6,8,3 (3ct 0st),0.612,2006,2019,KD Karthik ,INDIA
85,22,22,19,15,4,11,4,4 (4ct 0st),0.863,2015,2019,R Mutumbami ,ZIM
86,30,30,19,19,0,0,19,3 (3ct 0st),0.633,2008,2019,RR Patel ,KENYA
87,76,75,19,19,0,0,19,2 (2ct 0st),0.253,2006,2019,Shakib Al Hasan ,BDESH
88,38,38,19,17,2,15,2,3 (3ct 0st),0.5,2006,2019,BRM Taylor ,ZIM
89,43,42,19,19,0,0,19,2 (2ct 0st),0.452,2009,2019,RE van der Merwe ,NL
90,33,33,18,18,0,0,18,4 (4ct 0st),0.545,2012,2019,C de Grandhomme ,NZ
91,58,58,18,18,0,0,18,2 (2ct 0st),0.31,2011,2019,S Dhawan ,INDIA
92,45,45,18,18,0,0,18,2 (2ct 0st),0.4,2012,2019,Gulbadin Naib ,AFG
93,31,29,18,18,0,0,18,3 (3ct 0st),0.62,2013,2019,MA Leask ,SCOT
94,60,59,18,18,0,0,18,2 (2ct 0st),0.305,2012,2019,C Munro ,NZ
95,32,32,18,18,0,0,18,2 (2ct 0st),0.562,2012,2019,JE Root ,ENG
96,62,62,18,18,0,0,18,1 (1ct 0st),0.29,2010,2019,Samiullah Shinwari ,AFG
97,33,33,18,18,0,0,18,2 (2ct 0st),0.545,2005,2011,GC Smith ,SA
98,75,73,18,18,0,0,18,2 (2ct 0st),0.24600000000000002,2007,2018,Tamim Iqbal ,BDESH
99,60,60,18,18,0,0,18,2 (2ct 0st),0.3,2007,2016,Umar Gul ,PAK
100,40,40,17,17,0,0,17,2 (2ct 0st),0.425,2006,2012,J Botha ,SA
101,13,13,17,17,0,17,0,4 (4ct 0st),1.307,2005,2008,AC Gilchrist ,AUS
102,55,55,17,17,0,0,17,2 (2ct 0st),0.309,2006,2014,DPMD Jayawardene ,SL
103,43,43,17,17,0,0,17,3 (3ct 0st),0.395,2006,2017,CK Kapugedera ,SL
104,58,58,17,17,0,0,17,2 (2ct 0st),0.293,2008,2017,KMDN Kulasekara ,SL
105,50,50,17,17,0,0,17,2 (2ct 0st),0.34,2005,2015,JA Morkel ,SA
106,42,42,17,13,4,7,6,3 (2ct 1st),0.40399999999999997,2013,2019,MDKJ Perera ,SL
107,32,32,17,17,0,0,17,2 (2ct 0st),0.531,2013,2019,Sikandar Raza ,ZIM
108,17,17,17,17,0,0,17,3 (3ct 0st),1.0,2019,2019,BDH Stevens ,JER
109,17,16,17,14,3,14,0,3 (3ct 0st),1.062,2015,2017,Sultan Ahmed ,OMAN
110,24,24,16,16,0,0,16,4 (4ct 0st),0.6659999999999999,2014,2017,Babar Hayat ,HKG
111,26,26,16,15,1,4,11,3 (2ct 1st),0.615,2015,2019,SW Billings ,ENG
112,17,17,16,15,1,15,0,5 (5ct 0st),0.941,2019,2019,K Doriga ,PNG
113,15,15,16,12,4,12,0,3 (3ct 0st),1.0659999999999998,2013,2019,Hamza Tariq ,CAN
114,17,17,16,16,0,0,16,4 (4ct 0st),0.941,2019,2019,JW Jenner ,JER
115,30,30,16,16,0,0,16,3 (3ct 0st),0.5329999999999999,2014,2019,P Khadka ,NEPAL
116,32,32,16,16,0,0,16,3 (3ct 0st),0.5,2010,2017,Nawroz Mangal ,AFG
117,20,20,16,16,0,0,16,4 (4ct 0st),0.8,2011,2016,AM Rahane ,INDIA
118,48,47,16,16,0,0,16,2 (2ct 0st),0.34,2009,2019,WB Rankin ,ENG
119,45,45,16,16,0,0,16,2 (2ct 0st),0.355,2015,2019,Rashid Khan ,AFG
120,46,46,16,14,2,1,13,3 (3ct 0st),0.34700000000000003,2010,2019,Shafiqullah ,AFG
121,59,59,15,15,0,0,15,2 (2ct 0st),0.254,2009,2019,Ahmed Shehzad ,PAK
122,36,36,15,15,0,0,15,2 (2ct 0st),0.41600000000000004,2016,2019,Babar Azam ,PAK
123,27,27,15,10,5,7,3,3 (3ct 0st),0.555,2014,2019,B Bhandari ,NEPAL
124,36,36,15,15,0,0,15,2 (2ct 0st),0.41600000000000004,2005,2017,PD Collingwood ,ENG
125,58,58,15,15,0,0,15,1 (1ct 0st),0.258,2006,2019,CH Gayle ,WI
126,17,17,15,14,1,14,0,2 (2ct 0st),0.882,2016,2019,Ghulam Shabber ,UAE
127,16,16,15,10,5,10,0,4 (3ct 1st),0.937,2019,2019,ZE Green ,NAM
128,31,30,15,15,0,0,15,2 (2ct 0st),0.5,2011,2016,Nasir Hossain ,BDESH
129,25,23,15,13,2,8,5,2 (2ct 0st),0.652,2015,2019,SW Poynter ,IRE
130,26,26,15,13,2,13,0,3 (2ct 1st),0.5760000000000001,2011,2016,MS Wade ,AUS
131,19,19,15,13,2,10,3,3 (3ct 0st),0.789,2014,2018,CAK Walton ,WI
132,38,38,15,15,0,0,15,2 (2ct 0st),0.39399999999999996,2006,2019,SC Williams ,ZIM
133,13,13,14,14,0,14,0,3 (3ct 0st),1.0759999999999998,2014,2016,JJ Atkinson ,HKG
134,37,35,14,14,0,0,14,2 (2ct 0st),0.4,2015,2019,A Balbirnie ,IRE
135,38,38,14,14,0,0,14,2 (2ct 0st),0.368,2012,2018,F Behardien ,SA
136,34,34,14,14,0,0,14,2 (2ct 0st),0.41100000000000003,2017,2019,Fakhar Zaman ,PAK
137,41,41,14,14,0,0,14,2 (2ct 0st),0.341,2015,2019,Imad Wasim ,PAK
138,16,16,14,11,3,9,2,5 (2ct 3st),0.875,2013,2019,IA Karim ,KENYA
139,24,24,14,14,0,0,14,3 (3ct 0st),0.583,2014,2019,G Malla ,NEPAL
140,39,39,14,14,0,0,14,2 (2ct 0st),0.358,2007,2012,Misbah-ul-Haq ,PAK
141,36,35,14,14,0,0,14,2 (2ct 0st),0.4,2015,2019,MP O'Dowd ,NL
142,37,36,14,14,0,0,14,3 (3ct 0st),0.38799999999999996,2005,2013,KP Pietersen ,ENG
143,39,38,14,14,0,0,14,2 (2ct 0st),0.368,2015,2019,MJ Santner ,NZ
144,26,26,14,14,0,0,14,3 (3ct 0st),0.5379999999999999,2015,2019,A Vala ,PNG
145,14,14,14,10,4,10,0,3 (3ct 0st),1.0,2019,2019,J Vira ,VAN
146,51,50,14,14,0,0,14,2 (2ct 0st),0.28,2007,2014,LJ Wright ,ENG
147,21,21,13,13,0,0,13,2 (2ct 0st),0.619,2016,2019,AC Agar ,AUS
148,36,36,13,13,0,0,13,2 (2ct 0st),0.361,2014,2019,Ahmed Raza ,UAE
149,31,30,13,13,0,0,13,2 (2ct 0st),0.433,2012,2017,Ahsan Malik ,NL
150,15,14,13,13,0,1,12,3 (3ct 0st),0.9279999999999999,2017,2019,TC Bruce ,NZ
151,34,34,13,13,0,0,13,2 (2ct 0st),0.382,2005,2010,MJ Clarke ,AUS
152,28,27,13,13,0,0,13,2 (2ct 0st),0.48100000000000004,2013,2019,NM Coulter-Nile ,AUS
153,38,38,13,13,0,0,13,2 (2ct 0st),0.342,2006,2013,JEC Franklin ,NZ
154,25,25,13,13,0,0,13,2 (2ct 0st),0.52,2015,2019,Liton Das ,BDESH
155,27,27,13,13,0,0,13,2 (2ct 0st),0.48100000000000004,2009,2015,JF Mooney ,IRE
156,22,22,13,8,5,8,0,2 (2ct 0st),0.59,2007,2013,MA Ouma ,KENYA
157,12,12,13,11,2,11,0,3 (3ct 0st),1.083,2009,2017,TD Paine ,AUS
158,18,18,13,9,4,9,0,2 (2ct 0st),0.722,2014,2016,SP Patil ,UAE
159,34,34,13,13,0,0,13,2 (2ct 0st),0.382,2016,2019,KL Rahul ,INDIA
160,25,24,12,12,0,0,12,2 (2ct 0st),0.5,2015,2019,Aamir Kaleem ,OMAN
161,27,27,12,12,0,0,12,3 (3ct 0st),0.444,2013,2019,TA Boult ,NZ
162,34,34,12,10,2,0,10,2 (2ct 0st),0.35200000000000004,2011,2016,J Charles ,WI
163,21,20,12,12,0,0,12,2 (2ct 0st),0.6,2012,2019,JH Davey ,SCOT
164,22,22,12,12,0,0,12,3 (3ct 0st),0.545,2010,2019,CR Ervine ,ZIM
165,38,36,12,12,0,0,12,3 (3ct 0st),0.33299999999999996,2015,2019,HG Munsey ,SCOT
166,24,24,12,12,0,0,12,2 (2ct 0st),0.5,2014,2017,Nadeem Ahmed ,HKG
167,36,36,12,12,0,0,12,2 (2ct 0st),0.33299999999999996,2005,2012,JDP Oram ,NZ
168,64,64,12,12,0,0,12,2 (2ct 0st),0.187,2009,2015,Saeed Ajmal ,PAK
169,67,67,12,12,0,0,12,2 (2ct 0st),0.179,2007,2018,MN Samuels ,WI
170,19,19,12,8,4,8,0,2 (2ct 0st),0.631,2018,2019,TL Seifert ,NZ
171,26,26,12,12,0,0,12,3 (3ct 0st),0.461,2007,2016,V Sibanda ,ZIM
172,12,12,12,12,0,0,12,2 (2ct 0st),1.0,2019,2019,Tamoor Sajjad ,QAT
173,25,25,12,12,0,0,12,2 (2ct 0st),0.48,2007,2013,HA Varaiya ,KENYA
174,28,28,12,12,0,0,12,2 (2ct 0st),0.428,2015,2019,DJ Willey ,ENG
175,25,25,12,12,0,0,12,2 (2ct 0st),0.48,2006,2010,Younis Khan ,PAK
176,58,57,12,12,0,0,12,2 (2ct 0st),0.21,2007,2017,Yuvraj Singh ,INDIA
177,9,9,11,5,6,5,0,2 (1ct 1st),1.222,2008,2013,A Bagai ,CAN
178,12,12,11,11,0,0,11,3 (3ct 0st),0.9159999999999999,2019,2019,S Chandramohan ,SGP
179,12,12,11,11,0,0,11,4 (4ct 0st),0.9159999999999999,2019,2019,TH David ,SGP
180,16,16,11,11,0,0,11,3 (3ct 0st),0.687,2019,2019,N Davin ,NAM
181,17,17,11,6,5,6,0,1 (1ct 0st),0.647,2019,2019,JSE Dunford ,JER
182,16,16,11,11,0,0,11,2 (2ct 0st),0.687,2019,2019,MG Erasmus ,NAM
183,24,24,11,11,0,0,11,2 (2ct 0st),0.45799999999999996,2012,2017,JP Faulkner ,AUS
184,37,36,11,11,0,0,11,2 (2ct 0st),0.305,2007,2012,G Gambhir ,INDIA
185,25,25,11,11,0,0,11,2 (2ct 0st),0.44,2007,2012,Imran Nazir ,PAK
186,25,25,11,11,0,0,11,2 (2ct 0st),0.44,2015,2019,Jatinder Singh ,OMAN
187,29,28,11,11,0,0,11,2 (2ct 0st),0.392,2015,2019,Khawar Ali ,OMAN
188,15,15,11,8,3,8,0,3 (2ct 1st),0.733,2019,2019,Mohammed Rizlan ,QAT
189,24,22,11,11,0,0,11,2 (2ct 0st),0.5,2012,2016,PL Mommsen ,SCOT
190,11,10,11,9,2,7,2,4 (3ct 1st),1.1,2017,2018,GD Phillips ,NZ
191,24,24,11,11,0,0,11,2 (2ct 0st),0.45799999999999996,2008,2019,Rizwan Cheema ,CAN
192,38,38,11,11,0,0,11,2 (2ct 0st),0.289,2014,2019,Rohan Mustafa ,UAE
193,47,47,11,11,0,0,11,2 (2ct 0st),0.23399999999999999,2011,2018,AD Russell ,WI
194,38,38,11,11,0,0,11,1 (1ct 0st),0.289,2017,2019,Shadab Khan ,PAK
195,32,32,11,11,0,0,11,2 (2ct 0st),0.34299999999999997,2014,2019,Shaiman Anwar ,UAE
196,44,44,11,11,0,0,11,1 (1ct 0st),0.25,2007,2019,DW Steyn ,SA
197,17,17,11,6,5,6,0,3 (0ct 3st),0.647,2007,2012,T Taibu ,ZIM
198,41,39,11,11,0,0,11,2 (2ct 0st),0.282,2013,2019,PA van Meekeren ,NL
199,6,6,11,9,2,9,0,4 (3ct 1st),1.8330000000000002,2019,2019,D Weston ,GER
200,34,33,10,10,0,0,10,2 (2ct 0st),0.303,2006,2014,Abdur Razzak ,BDESH
201,30,30,10,10,0,0,10,2 (2ct 0st),0.33299999999999996,2012,2017,GJ Bailey ,AUS
202,24,24,10,10,0,0,10,3 (3ct 0st),0.41600000000000004,2008,2016,SJ Benn ,WI
203,34,34,10,10,0,0,10,2 (2ct 0st),0.294,2006,2014,TT Bresnan ,ENG
204,16,16,10,10,0,0,10,2 (2ct 0st),0.625,2018,2019,RP Burl ,ZIM
205,22,22,10,10,0,0,10,2 (2ct 0st),0.45399999999999996,2014,2019,SS Cottrell ,WI
206,23,23,10,10,0,9,1,2 (2ct 0st),0.434,2016,2019,N Dickwella ,SL
207,5,5,10,7,3,7,0,3 (3ct 0st),2.0,2019,2019,R Escobar ,Arg
208,21,20,10,10,0,0,10,2 (2ct 0st),0.5,2018,2019,FJ Klaassen ,NL
209,54,53,10,10,0,0,10,3 (3ct 0st),0.188,2006,2017,Mashrafe Mortaza ,BDESH
210,34,34,10,10,0,0,10,2 (2ct 0st),0.294,2014,2019,Nizakat Khan ,HKG
211,14,14,10,10,0,0,10,3 (3ct 0st),0.7140000000000001,2008,2015,JL Ontong ,SA
212,21,21,10,10,0,0,10,2 (2ct 0st),0.47600000000000003,2006,2014,RJ Peterson ,SA
213,40,40,10,10,0,0,10,2 (2ct 0st),0.25,2009,2019,AU Rashid ,ENG
214,42,41,10,10,0,0,10,2 (2ct 0st),0.243,2012,2019,SM Sharif ,SCOT
215,12,12,10,10,0,0,10,3 (3ct 0st),0.833,2019,2019,JJ Smit ,NAM
216,14,14,10,10,0,2,8,2 (2ct 0st),0.7140000000000001,2016,2019,LJ Tucker ,IRE
217,19,19,10,10,0,0,10,2 (2ct 0st),0.526,2015,2019,Usman Ghani ,AFG
218,25,25,9,9,0,0,9,1 (1ct 0st),0.36,2018,2019,Asif Ali ,PAK
219,38,36,9,9,0,0,9,2 (2ct 0st),0.25,2008,2016,Mudassar Bukhari ,NL
220,33,33,9,9,0,0,9,2 (2ct 0st),0.272,2006,2018,CJ Chibhabha ,ZIM
221,21,21,9,9,0,0,9,3 (3ct 0st),0.428,2016,2019,MD Gunathilaka ,SL
222,30,28,9,9,0,0,9,3 (3ct 0st),0.321,2008,2013,DT Johnston ,IRE
223,25,25,9,9,0,0,9,2 (2ct 0st),0.36,2015,2019,Karan KC ,NEPAL
224,29,29,9,9,0,0,9,2 (2ct 0st),0.31,2016,2019,E Lewis ,WI
225,11,11,9,9,0,9,0,3 (3ct 0st),0.818,2006,2010,PD McGlashan ,NZ
226,8,7,9,6,3,6,0,4 (3ct 1st),1.285,2019,2019,Manpreet Singh ,ITA
227,7,7,9,8,1,8,0,3 (3ct 0st),1.285,2019,2019,Mohamed Azzam ,Mald
228,16,16,9,9,0,0,9,2 (2ct 0st),0.562,2007,2009,J Mubarak ,SL
229,37,37,9,9,0,0,9,3 (3ct 0st),0.243,2015,2019,Mustafizur Rahman ,BDESH
230,28,28,9,9,0,0,9,2 (2ct 0st),0.321,2010,2019,SO Ngoche ,KENYA
231,26,26,9,6,3,4,2,2 (2ct 0st),0.34600000000000003,2017,2019,RR Pant ,INDIA
232,22,22,9,9,0,0,9,2 (2ct 0st),0.409,2007,2012,YK Pathan ,INDIA
233,23,23,9,9,0,0,9,2 (2ct 0st),0.391,2017,2019,R Powell ,WI
234,10,10,9,6,3,6,0,4 (4ct 0st),0.9,2007,2010,MJ Prior ,ENG
235,11,11,9,9,0,0,9,3 (3ct 0st),0.818,2019,2019,DMW Rawlins ,BMUDA
236,9,9,9,9,0,0,9,2 (2ct 0st),1.0,2017,2019,JA Richardson ,AUS
237,15,15,9,9,0,0,9,3 (3ct 0st),0.6,2014,2016,RR Rossouw ,SA
238,8,7,9,5,4,5,0,2 (2ct 0st),1.285,2007,2009,CJO Smith ,SCOT
239,40,39,9,9,0,0,9,1 (1ct 0st),0.23,2014,2019,IS Sodhi ,NZ
240,26,24,9,9,0,0,9,2 (2ct 0st),0.375,2012,2016,MC Sorensen ,IRE
241,23,22,9,9,0,0,9,3 (3ct 0st),0.409,2011,2018,BA Stokes ,ENG
242,17,17,9,9,0,0,9,3 (3ct 0st),0.529,2017,2019,Sultan Ahmed ,UAE
243,13,13,9,7,2,7,0,2 (2ct 0st),0.6920000000000001,2019,2019,Suraj Kumar ,OMAN
244,30,30,9,9,0,0,9,1 (1ct 0st),0.3,2006,2018,JE Taylor ,WI
245,39,38,9,9,0,0,9,2 (2ct 0st),0.23600000000000002,2012,2019,T van der Gugten ,NL
246,34,34,9,9,0,0,9,2 (2ct 0st),0.264,2007,2014,DL Vettori ,NZ
247,19,18,9,7,2,6,1,2 (2ct 0st),0.5,2012,2019,CD Wallace ,SCOT
248,32,32,9,9,0,0,9,1 (1ct 0st),0.281,2011,2018,MN Waller ,ZIM
249,20,20,9,9,0,0,9,2 (2ct 0st),0.45,2013,2016,D Wiese ,SA
250,13,13,9,9,0,0,9,3 (3ct 0st),0.6920000000000001,2019,2019,Zaheer Ibrahim ,QAT
251,30,30,8,8,0,0,8,2 (2ct 0st),0.266,2014,2019,Aizaz Khan ,HKG
252,46,46,8,8,0,0,8,1 (1ct 0st),0.17300000000000001,2010,2017,R Ashwin ,INDIA
253,23,23,8,8,0,0,8,3 (3ct 0st),0.34700000000000003,2016,2019,S Bau ,PNG
254,17,17,8,8,0,0,8,2 (2ct 0st),0.47,2019,2019,DG Blampied ,JER
255,14,13,8,8,0,0,8,2 (2ct 0st),0.615,2008,2010,AC Botha ,IRE
256,34,33,8,8,0,0,8,2 (2ct 0st),0.242,2011,2014,JW Dernbach ,ENG
257,14,14,8,8,0,0,8,2 (2ct 0st),0.5710000000000001,2019,2019,JN Frylinck ,NAM
258,23,23,8,8,0,0,8,3 (3ct 0st),0.34700000000000003,2005,2010,HH Gibbs ,SA
259,22,22,8,8,0,0,8,1 (1ct 0st),0.363,2014,2019,RR Hendricks ,SA
260,9,9,8,8,0,5,3,2 (2ct 0st),0.888,2018,2019,H Klaasen ,SA
261,27,26,8,8,0,0,8,1 (1ct 0st),0.307,2010,2014,MJ Lumb ,ENG
262,12,11,8,8,0,0,8,3 (3ct 0st),0.727,2018,2019,BR McDermott ,AUS
263,12,12,8,4,4,4,0,2 (1ct 1st),0.6659999999999999,2019,2019,Manpreet Singh ,SGP
264,42,42,8,8,0,0,8,1 (1ct 0st),0.19,2005,2014,KD Mills ,NZ
265,9,9,8,8,0,0,8,2 (2ct 0st),0.888,2019,2019,DJ Mitchell ,NZ
266,22,22,8,8,0,0,8,3 (3ct 0st),0.363,2015,2019,Mohammad Nadeem ,OMAN
267,7,7,8,6,2,6,0,3 (2ct 1st),1.1420000000000001,2017,2017,M Mosehle ,SA
268,14,14,8,8,0,0,8,2 (2ct 0st),0.5710000000000001,2019,2019,Nouman Sarwar ,QAT
269,17,17,8,8,0,0,8,2 (2ct 0st),0.47,2005,2009,RT Ponting ,AUS
270,22,22,8,8,0,0,8,2 (2ct 0st),0.363,2016,2019,Rameez Shahzad ,UAE
271,12,12,8,8,0,0,8,2 (2ct 0st),0.6659999999999999,2019,2019,Ravinderpal Singh ,CAN
272,15,15,8,8,0,0,8,2 (2ct 0st),0.5329999999999999,2014,2019,KW Richardson ,AUS
273,20,19,8,8,0,0,8,2 (2ct 0st),0.42100000000000004,2018,2019,DJM Short ,AUS
274,33,33,8,8,0,0,8,1 (1ct 0st),0.242,2006,2015,DR Smith ,WI
275,28,28,8,8,0,0,8,2 (2ct 0st),0.285,2014,2019,Sompal Kami ,NEPAL
276,28,28,8,8,0,0,8,2 (2ct 0st),0.285,2012,2019,MA Starc ,AUS
277,31,31,8,8,0,0,8,2 (2ct 0st),0.258,2005,2010,SB Styris ,NZ
278,9,9,8,8,0,0,8,2 (2ct 0st),0.888,2013,2016,RML Taylor ,SCOT
279,14,14,8,8,0,0,8,2 (2ct 0st),0.5710000000000001,2019,2019,HT Tector ,IRE
280,26,26,8,8,0,0,8,1 (1ct 0st),0.307,2012,2016,HDRL Thirimanne ,SL
281,26,25,8,8,0,0,8,2 (2ct 0st),0.32,2016,2018,AJ Tye ,AUS
282,25,25,8,8,0,0,8,2 (2ct 0st),0.32,2015,2019,N Vanua ,PNG
283,14,14,8,8,0,0,8,2 (2ct 0st),0.5710000000000001,2006,2011,MH Yardy ,ENG
284,21,21,7,7,0,0,7,2 (2ct 0st),0.33299999999999996,2013,2016,KJ Abbott ,SA
285,20,20,7,7,0,0,7,2 (2ct 0st),0.35,2008,2013,RG Aga ,KENYA
286,25,25,7,7,0,0,7,2 (2ct 0st),0.28,2014,2018,MM Ali ,ENG
287,22,22,7,7,0,0,7,2 (2ct 0st),0.318,2015,2019,Aqib Ilyas ,OMAN
288,52,52,7,7,0,0,7,2 (2ct 0st),0.134,2012,2018,S Badree ,WI
289,17,17,7,7,0,0,7,2 (2ct 0st),0.41100000000000003,2008,2013,HS Baidwan ,CAN
290,61,59,7,7,0,0,7,2 (2ct 0st),0.11800000000000001,2008,2019,RD Berrington ,SCOT
291,32,31,7,7,0,0,7,2 (2ct 0st),0.225,2015,2019,Bilal Khan ,OMAN
292,38,37,7,7,0,0,7,2 (2ct 0st),0.18899999999999997,2008,2014,RS Bopara ,ENG
293,18,17,7,7,0,0,7,2 (2ct 0st),0.41100000000000003,2011,2019,DAJ Bracewell ,NZ
294,36,36,7,7,0,0,7,2 (2ct 0st),0.19399999999999998,2016,2019,YS Chahal ,INDIA
295,22,22,7,7,0,0,7,1 (1ct 0st),0.318,2006,2010,S Chanderpaul ,WI
296,24,24,7,7,0,0,7,2 (2ct 0st),0.29100000000000004,2014,2018,MS Chapman ,HKG
297,25,25,7,7,0,0,7,1 (1ct 0st),0.28,2011,2019,PJ Cummins ,AUS
298,37,33,7,7,0,0,7,2 (2ct 0st),0.212,2008,2015,AR Cusack ,IRE
299,34,34,7,7,0,0,7,2 (2ct 0st),0.205,2012,2019,Dawlat Zadran ,AFG
300,5,5,7,5,2,4,1,3 (1ct 2st),1.4,2014,2017,BR Dunk ,AUS
301,27,25,7,7,0,0,7,1 (1ct 0st),0.28,2015,2019,AC Evans ,SCOT
302,27,27,7,7,0,0,7,2 (2ct 0st),0.259,2017,2019,Faheem Ashraf ,PAK
303,24,24,7,7,0,0,7,2 (2ct 0st),0.29100000000000004,2007,2010,Fawad Alam ,PAK
304,28,27,7,7,0,0,7,2 (2ct 0st),0.259,2006,2016,Harbhajan Singh ,INDIA
305,30,30,7,7,0,0,7,1 (1ct 0st),0.233,2016,2019,Hasan Ali ,PAK
306,16,16,7,7,0,0,7,2 (2ct 0st),0.43700000000000006,2019,2019,AW Hawkins-Kay ,JER
307,17,17,7,7,0,0,7,2 (2ct 0st),0.41100000000000003,2014,2019,JO Holder ,WI
308,38,38,7,7,0,0,7,2 (2ct 0st),0.184,2013,2019,Imran Tahir ,SA
309,15,15,7,7,0,0,7,2 (2ct 0st),0.466,2019,2019,Iqbal Hussain ,QAT
310,25,25,7,7,0,0,7,2 (2ct 0st),0.28,2005,2012,JH Kallis ,SA
311,19,19,7,7,0,0,7,2 (2ct 0st),0.368,2017,2019,Kuldeep Yadav ,INDIA
312,29,29,7,7,0,0,7,1 (1ct 0st),0.24100000000000002,2012,2018,MJ McClenaghan ,NZ
313,13,13,7,7,0,0,7,1 (1ct 0st),0.5379999999999999,2013,2016,MW Machan ,SCOT
314,14,14,7,7,0,0,7,2 (2ct 0st),0.5,2007,2009,AD Mascarenhas ,ENG
315,13,13,7,7,0,0,7,2 (2ct 0st),0.5379999999999999,2017,2018,Mehidy Hasan Miraz ,BDESH
316,22,22,7,7,0,0,7,2 (2ct 0st),0.318,2011,2018,BMAJ Mendis ,SL
317,5,5,7,5,2,3,2,3 (2ct 1st),1.4,2019,2019,AK Mohan ,Fin
318,21,21,7,7,0,2,5,2 (2ct 0st),0.33299999999999996,2016,2019,PJ Moor ,ZIM
319,14,14,7,7,0,0,7,2 (2ct 0st),0.5,2016,2019,Mosaddek Hossain ,BDESH
320,7,7,7,3,4,3,0,4 (2ct 2st),1.0,2019,2019,K Motlhanka ,Botsw
321,51,51,7,7,0,0,7,2 (2ct 0st),0.13699999999999998,2012,2019,SP Narine ,WI
322,11,11,7,7,0,0,7,2 (2ct 0st),0.636,2008,2013,H Osinde ,CAN
323,32,32,7,7,0,0,7,2 (2ct 0st),0.218,2015,2019,MK Pandey ,INDIA
324,18,18,7,7,0,0,7,2 (2ct 0st),0.38799999999999996,2018,2019,KH Pandya ,INDIA
325,22,22,7,7,0,0,7,1 (1ct 0st),0.318,2006,2019,LE Plunkett ,ENG
326,16,16,7,7,0,3,4,2 (2ct 0st),0.43700000000000006,2016,2019,N Pooran ,WI
327,22,22,7,7,0,0,7,2 (2ct 0st),0.318,2008,2014,JD Ryder ,NZ
328,18,18,7,7,0,0,7,1 (1ct 0st),0.38799999999999996,2007,2010,RR Sarwan ,WI
329,35,35,7,7,0,0,7,2 (2ct 0st),0.2,2015,2019,MD Shanaka ,SL
330,18,18,7,7,0,0,7,2 (2ct 0st),0.38799999999999996,2018,2019,Simi Singh ,IRE
331,57,57,7,7,0,0,7,1 (1ct 0st),0.122,2007,2017,Sohail Tanvir ,PAK
332,19,18,7,7,0,0,7,1 (1ct 0st),0.38799999999999996,2015,2019,MP Stoinis ,AUS
333,26,26,7,7,0,0,7,1 (1ct 0st),0.26899999999999996,2012,2016,MR Swart ,NL
334,14,14,7,7,0,0,7,2 (2ct 0st),0.5,2019,2019,R Tari ,VAN
335,23,23,7,7,0,0,7,2 (2ct 0st),0.304,2015,2019,TP Ura ,PNG
336,22,22,7,7,0,0,7,2 (2ct 0st),0.318,2014,2019,Waqas Barkat ,HKG
337,35,33,7,7,0,0,7,1 (1ct 0st),0.212,2015,2019,MRJ Watt ,SCOT
338,24,24,7,7,0,0,7,1 (1ct 0st),0.29100000000000004,2016,2019,KOK Williams ,WI
339,9,9,7,7,0,0,7,2 (2ct 0st),0.777,2019,2019,Yasir Ali ,ESP
340,26,25,7,7,0,0,7,2 (2ct 0st),0.28,2015,2019,CA Young ,IRE
341,8,8,6,6,0,0,6,2 (2ct 0st),0.75,2007,2013,Abdur Rehman ,PAK
342,18,18,6,6,0,0,6,1 (1ct 0st),0.33299999999999996,2018,2019,DS Airee ,NEPAL
343,11,11,6,5,1,3,2,2 (2ct 0st),0.545,2015,2019,PS Airee ,NEPAL
344,20,20,6,6,0,0,6,1 (1ct 0st),0.3,2015,2017,Anshuman Rath ,HKG
345,9,9,6,5,1,5,0,1 (1ct 0st),0.6659999999999999,2019,2019,Awais Ahmed ,ESP
346,19,19,6,6,0,0,6,1 (1ct 0st),0.315,2006,2009,NW Bracken ,AUS
347,42,42,6,6,0,0,6,2 (2ct 0st),0.142,2016,2019,JJ Bumrah ,INDIA
348,19,19,6,6,0,0,6,2 (2ct 0st),0.315,2015,2018,PVD Chameera ,SL
349,18,17,6,6,0,0,6,2 (2ct 0st),0.35200000000000004,2012,2016,TLW Cooper ,NL
350,6,5,6,6,0,0,6,3 (3ct 0st),1.2,2019,2019,FA Cossa ,Moz
351,29,29,6,6,0,0,6,1 (1ct 0st),0.20600000000000002,2008,2018,AG Cremer ,ZIM
352,21,21,6,6,0,0,6,1 (1ct 0st),0.285,2011,2015,ST Finn ,ENG
353,5,5,6,3,3,3,0,2 (1ct 1st),1.2,2009,2009,JS Foster ,ENG
354,20,20,6,6,0,0,6,2 (2ct 0st),0.3,2018,2019,SO Hetmyer ,WI
355,13,13,6,6,0,6,0,2 (2ct 0st),0.461,2017,2019,SD Hope ,WI
356,10,10,6,4,2,2,2,2 (2ct 0st),0.6,2007,2010,GJ Hopkins ,NZ
357,7,6,6,6,0,5,1,2 (2ct 0st),1.0,2019,2019,Imran Ismail ,Moz
358,12,12,6,6,0,0,6,3 (3ct 0st),0.5,2019,2019,Janak Prakash ,SGP
359,14,14,6,6,0,0,6,2 (2ct 0st),0.428,2019,2019,Kamran Khan ,QAT
360,36,36,6,6,0,0,6,1 (1ct 0st),0.166,2010,2018,Karim Sadiq ,AFG
361,43,43,6,6,0,0,6,1 (1ct 0st),0.139,2012,2019,B Kumar ,INDIA
362,9,7,6,6,0,0,6,3 (3ct 0st),0.857,2019,2019,ND Laegsgaard ,DEN
363,13,13,6,6,0,4,2,3 (3ct 0st),0.461,2012,2017,TWM Latham ,NZ
364,25,25,6,6,0,0,6,3 (3ct 0st),0.24,2005,2012,B Lee ,AUS
365,19,18,6,6,0,0,6,2 (2ct 0st),0.33299999999999996,2014,2017,AR McBrine ,IRE
366,10,10,6,6,0,0,6,3 (3ct 0st),0.6,2019,2019,PK Matautaava ,VAN
367,39,39,6,6,0,0,6,1 (1ct 0st),0.153,2008,2014,BAW Mendis ,SL
368,24,24,6,6,0,0,6,1 (1ct 0st),0.25,2016,2019,BKG Mendis ,SL
369,16,16,6,6,0,0,6,1 (1ct 0st),0.375,2016,2018,Mohammad Nawaz ,PAK
370,23,23,6,6,0,0,6,2 (2ct 0st),0.26,2012,2019,CH Morris ,SA
371,34,34,6,6,0,0,6,1 (1ct 0st),0.17600000000000002,2016,2019,Muhammad Usman ,UAE
372,18,18,6,6,0,0,6,2 (2ct 0st),0.33299999999999996,2012,2013,Nasir Jamshed ,PAK
373,13,13,6,6,0,0,6,2 (2ct 0st),0.461,2011,2019,AR Nurse ,WI
374,9,9,6,2,4,2,0,2 (0ct 2st),0.6659999999999999,2016,2017,Nurul Hasan ,BDESH
375,24,24,6,6,0,0,6,1 (1ct 0st),0.25,2007,2013,NN Odhiambo ,KENYA
376,7,7,6,6,0,0,6,2 (2ct 0st),0.857,2019,2019,HH Patel ,MWI
377,15,15,6,6,0,0,6,1 (1ct 0st),0.4,2019,2019,CW Perchard ,JER
378,8,7,6,6,0,0,6,3 (3ct 0st),0.857,2019,2019,BBJL Perera ,ITA
379,23,23,6,6,0,0,6,2 (2ct 0st),0.26,2017,2019,AL Phehlukwayo ,SA
380,7,6,6,6,0,0,6,2 (2ct 0st),1.0,2019,2019,Rehman Abdul ,ITA
381,7,7,6,4,2,3,1,2 (1ct 1st),0.857,2017,2019,S Samarawickrama ,SL
382,4,4,6,4,2,4,0,3 (3ct 0st),1.5,2019,2019,Shafraz Jaleel ,Mald
383,9,7,6,6,0,0,6,3 (3ct 0st),0.857,2019,2019,HAM Shah ,DEN
384,22,22,6,6,0,0,6,2 (2ct 0st),0.272,2015,2017,TAM Siriwardana ,SL
385,35,35,6,6,0,0,6,1 (1ct 0st),0.171,2006,2015,P Utseya ,ZIM
386,8,8,6,5,1,3,2,1 (1ct 0st),0.75,2007,2015,MN van Wyk ,SA
387,8,8,6,4,2,4,0,3 (3ct 0st),0.75,2015,2017,JNT Vare ,PNG
388,17,17,6,6,0,0,6,1 (1ct 0st),0.35200000000000004,2014,2019,S Vesawkar ,NEPAL
389,12,12,6,6,0,0,6,2 (2ct 0st),0.5,2019,2019,Virandeep Singh ,MAL
390,11,10,6,6,0,0,6,3 (3ct 0st),0.6,2007,2012,DF Watts ,SCOT
391,29,28,6,6,0,0,6,2 (2ct 0st),0.214,2015,2019,Zeeshan Maqsood ,OMAN
392,11,11,5,5,0,0,5,1 (1ct 0st),0.45399999999999996,2018,2019,Aarif Sheikh ,NEPAL
393,12,11,5,5,0,0,5,3 (3ct 0st),0.45399999999999996,2015,2016,Adnan Ilyas ,OMAN
394,8,8,5,2,3,1,1,2 (0ct 2st),0.625,2019,2019,KK Ahuja ,Mex
395,23,23,5,5,0,0,5,1 (1ct 0st),0.217,2015,2019,CJA Amini ,PNG
396,16,16,5,5,0,0,5,2 (2ct 0st),0.312,2008,2016,Anwar Ali ,PAK
397,9,9,5,5,0,0,5,1 (1ct 0st),0.555,2018,2018,Ariful Haque ,BDESH
398,13,13,5,5,0,0,5,2 (2ct 0st),0.384,2019,2019,SJ Baard ,NAM
399,11,11,5,4,1,2,2,2 (2ct 0st),0.45399999999999996,2019,2019,O Bascome ,BMUDA
400,12,12,5,5,0,0,5,2 (2ct 0st),0.41600000000000004,2018,2019,PKD Chase ,IRE
401,16,16,5,5,0,0,5,2 (2ct 0st),0.312,2010,2017,DT Christian ,AUS
402,7,7,5,5,0,0,5,3 (3ct 0st),0.7140000000000001,2013,2017,BCJ Cutting ,AUS
403,9,9,5,5,0,0,5,2 (2ct 0st),0.555,2015,2017,MD Dai ,PNG
404,22,22,5,5,0,0,5,1 (1ct 0st),0.22699999999999998,2012,2019,A Dananjaya ,SL
405,17,17,5,5,0,0,5,2 (2ct 0st),0.294,2019,2019,GJ Delany ,IRE
406,12,12,5,5,0,0,5,1 (1ct 0st),0.41600000000000004,2019,2019,NS Dhaliwal ,CAN
407,10,10,5,5,0,0,5,3 (3ct 0st),0.5,2019,2019,AC Douglas ,BMUDA
408,20,20,5,5,0,0,5,1 (1ct 0st),0.25,2007,2012,FH Edwards ,WI
409,3,3,5,4,1,2,2,3 (2ct 1st),1.666,2019,2019,Fahad Ali ,
410,15,15,5,5,0,0,5,1 (1ct 0st),0.33299999999999996,2019,2019,Faisal Javed ,QAT
411,9,9,5,5,0,0,5,1 (1ct 0st),0.555,2019,2019,LB Ferbrache ,GUE
412,7,7,5,5,0,0,5,2 (2ct 0st),0.7140000000000001,2005,2007,A Flintoff ,ENG
413,11,11,5,5,0,0,5,1 (1ct 0st),0.45399999999999996,2013,2019,DM Gondaria ,KENYA
414,8,8,5,5,0,0,5,3 (3ct 0st),0.625,2019,2019,NA Greenwood ,JER
415,12,12,5,5,0,0,5,2 (2ct 0st),0.41600000000000004,2016,2017,DAS Gunaratne ,SL
416,4,4,5,4,1,4,0,3 (3ct 0st),1.25,2019,2019,S Hallett ,Peru
417,7,7,5,5,0,5,0,3 (3ct 0st),0.7140000000000001,2019,2019,Hilal Ahmad ,CZK-R
418,15,15,5,5,0,0,5,1 (1ct 0st),0.33299999999999996,2007,2014,BJ Hodge ,AUS
419,11,11,5,5,0,0,5,2 (2ct 0st),0.45399999999999996,2019,2019,Ibrahim Hassan ,Mald
420,4,4,5,5,0,0,5,3 (3ct 0st),1.25,2019,2019,Jagjit Singh ,Peru
421,22,22,5,5,0,0,5,1 (1ct 0st),0.22699999999999998,2011,2019,KM Jarvis ,ZIM
422,30,30,5,5,0,0,5,1 (1ct 0st),0.166,2007,2013,MG Johnson ,AUS
423,18,17,5,5,0,0,5,2 (2ct 0st),0.294,2006,2014,EC Joyce ,ENG
424,5,5,5,5,0,0,5,2 (2ct 0st),1.0,2019,2019,Junaid Sheikh ,NOR
425,7,7,5,5,0,0,5,2 (2ct 0st),0.7140000000000001,2019,2019,D Kansonkho ,MWI
426,21,21,5,5,0,0,5,2 (2ct 0st),0.23800000000000002,2016,2019,Karim Janat ,AFG
427,8,8,5,2,3,2,0,2 (0ct 2st),0.625,2014,2015,SP Khakurel ,NEPAL
428,9,9,5,5,0,0,5,1 (1ct 0st),0.555,2016,2016,UT Khawaja ,AUS
429,12,12,5,5,0,0,5,2 (2ct 0st),0.41600000000000004,2019,2019,JP Kotze ,NAM
430,7,7,5,5,0,4,1,3 (3ct 0st),0.7140000000000001,2009,2017,HG Kuhn ,SA
431,18,18,5,5,0,0,5,2 (2ct 0st),0.27699999999999997,2012,2019,NR Kumar ,CAN
432,17,16,5,5,0,0,5,2 (2ct 0st),0.312,2015,2019,AV Lalcheta ,OMAN
433,6,6,5,2,3,2,0,2 (0ct 2st),0.833,2019,2019,JS Malhotra ,USA
434,14,14,5,5,0,0,5,2 (2ct 0st),0.35700000000000004,2019,2019,A Mansale ,VAN
435,13,13,5,5,0,0,5,1 (1ct 0st),0.384,2008,2019,T Maruma ,ZIM
436,10,10,5,5,0,0,5,2 (2ct 0st),0.5,2006,2012,S Matsikenyeri ,ZIM
437,10,10,5,4,1,4,0,2 (2ct 0st),0.5,2019,2019,SS McKechnie ,HKG
438,14,14,5,5,0,0,5,2 (2ct 0st),0.35700000000000004,2019,2019,EJB Miles ,JER
439,21,21,5,5,0,0,5,1 (1ct 0st),0.23800000000000002,2010,2018,AF Milne ,NZ
440,25,25,5,5,0,0,5,1 (1ct 0st),0.2,2010,2016,Mirwais Ashraf ,AFG
441,16,16,5,3,2,3,0,2 (2ct 0st),0.312,2015,2019,Mohammad Rizwan ,PAK
442,15,15,5,5,0,0,5,2 (2ct 0st),0.33299999999999996,2019,2019,Mohammed Nadeem ,QAT
443,44,44,5,5,0,0,5,1 (1ct 0st),0.113,2007,2017,M Morkel ,SA
444,30,30,5,5,0,0,5,2 (2ct 0st),0.166,2008,2019,CB Mpofu ,ZIM
445,15,15,5,5,0,0,5,2 (2ct 0st),0.33299999999999996,2019,2019,Muhammad Tanveer ,QAT
446,15,14,5,5,0,0,5,3 (3ct 0st),0.35700000000000004,2019,2019,S Muniandy ,MAL
447,9,9,5,5,0,0,5,2 (2ct 0st),0.555,2019,2019,C Munoz-Mills ,ESP
448,33,32,5,5,0,0,5,1 (1ct 0st),0.156,2012,2019,SJ Myburgh ,NL
449,18,18,5,5,0,0,5,2 (2ct 0st),0.27699999999999997,2012,2019,JDS Neesham ,NZ
450,7,7,5,5,0,0,5,3 (3ct 0st),0.7140000000000001,2019,2019,R Nehonde ,Botsw
451,7,7,5,4,1,4,0,2 (2ct 0st),0.7140000000000001,2019,2019,OE Newey ,GUE
452,21,21,5,5,0,0,5,2 (2ct 0st),0.23800000000000002,2010,2013,RJ Nicol ,NZ
453,16,16,5,5,0,0,5,2 (2ct 0st),0.312,2010,2019,NM Odhiambo ,KENYA
454,11,11,5,5,0,0,5,2 (2ct 0st),0.45399999999999996,2007,2013,TM Odoyo ,KENYA
455,9,9,5,5,0,0,5,3 (3ct 0st),0.555,2019,2019,CN Onwuzulike ,NGA
456,9,9,5,5,0,0,5,2 (2ct 0st),0.555,2019,2019,R Panchal ,ESP
457,40,40,5,5,0,0,5,1 (1ct 0st),0.125,2009,2017,WD Parnell ,SA
458,11,11,5,5,0,0,5,2 (2ct 0st),0.45399999999999996,2015,2018,AR Patel ,INDIA
459,8,8,5,3,2,1,2,2 (1ct 1st),0.625,2019,2019,MD Patel ,USA
460,4,4,5,5,0,0,5,2 (2ct 0st),1.25,2019,2019,NK Patel ,USA
461,7,7,5,4,1,4,0,2 (1ct 1st),0.7140000000000001,2019,2019,Rahmanullah Gurbaz ,AFG
462,13,13,5,5,0,0,5,1 (1ct 0st),0.384,2019,2019,J Rasu ,VAN
463,17,17,5,5,0,0,5,1 (1ct 0st),0.294,2019,2019,D Ravu ,PNG
464,32,32,5,5,0,0,5,1 (1ct 0st),0.156,2014,2018,JJ Roy ,ENG
465,7,7,5,5,0,0,5,2 (2ct 0st),0.7140000000000001,2019,2019,Sami Sohail ,MWI
466,12,12,5,5,0,0,5,2 (2ct 0st),0.41600000000000004,2019,2019,Sandeep Goud ,OMAN
467,7,6,5,5,0,0,5,1 (1ct 0st),0.833,2008,2010,E Schiferli ,NL
468,10,9,5,2,3,2,0,2 (2ct 0st),0.555,2019,2019,Shafiq Sharif ,MAL
469,26,26,5,5,0,0,5,2 (2ct 0st),0.192,2014,2019,KD Shah ,HKG
470,17,17,5,5,0,0,5,2 (2ct 0st),0.294,2007,2009,OA Shah ,ENG
471,34,34,5,5,0,0,5,1 (1ct 0st),0.147,2010,2018,Shapoor Zadran ,AFG
472,15,15,5,5,0,0,5,2 (2ct 0st),0.33299999999999996,2013,2016,Sharjeel Khan ,PAK
473,18,18,5,5,0,0,5,2 (2ct 0st),0.27699999999999997,2007,2010,RJ Sidebottom ,ENG
474,16,16,5,5,0,0,5,1 (1ct 0st),0.312,2006,2011,LPC Silva ,SL
475,9,9,5,5,0,0,5,1 (1ct 0st),0.555,2019,2019,TB Sole ,SCOT
476,39,39,5,5,0,0,5,1 (1ct 0st),0.128,2008,2012,GP Swann ,ENG
477,8,8,5,5,0,0,5,2 (2ct 0st),0.625,2019,2019,SR Taylor ,USA
478,15,15,5,5,0,0,5,2 (2ct 0st),0.33299999999999996,2007,2013,SO Tikolo ,KENYA
479,11,11,5,5,0,0,5,1 (1ct 0st),0.45399999999999996,2017,2019,AJ Turner ,AUS
480,12,12,5,5,0,0,5,1 (1ct 0st),0.41600000000000004,2019,2019,C Viljoen ,NAM
481,12,12,5,5,0,0,5,2 (2ct 0st),0.41600000000000004,2015,2019,JM Vince ,ENG
482,31,31,5,5,0,0,5,1 (1ct 0st),0.161,2008,2019,Wahab Riaz ,PAK
483,13,13,5,5,0,0,5,1 (1ct 0st),0.384,2019,2019,B Ward ,JER
484,18,18,5,5,0,0,5,1 (1ct 0st),0.27699999999999997,2017,2019,Washington Sundar ,INDIA
485,7,7,4,4,0,0,4,2 (2ct 0st),0.5710000000000001,2019,2019,Abdul-Shakoor Rahimzei ,GER
486,11,11,4,4,0,0,4,1 (1ct 0st),0.363,2019,2019,CN Ackermann ,NL
487,6,6,4,4,0,0,4,1 (1ct 0st),0.6659999999999999,2019,2019,Adnan Idrees ,KUW
488,11,11,4,4,0,0,4,2 (2ct 0st),0.363,2006,2010,Aftab Ahmed ,BDESH
489,11,11,4,4,0,0,4,2 (2ct 0st),0.363,2018,2019,FA Allen ,WI
490,22,22,4,4,0,0,4,1 (1ct 0st),0.18100000000000002,2014,2017,Amjad Javed ,UAE
491,4,4,4,0,4,0,0,2 (0ct 2st),1.0,2019,2019,SE Aquilina ,MALTA
492,9,9,4,4,0,0,4,1 (1ct 0st),0.444,2019,2019,Asad Mohammad ,GER
493,7,7,4,4,0,0,4,3 (3ct 0st),0.5710000000000001,2019,2019,MA Baig ,MWI
494,6,6,4,4,0,3,1,1 (1ct 0st),0.6659999999999999,2019,2019,B Banerjee ,Mex
495,3,3,4,4,0,0,4,2 (2ct 0st),1.3330000000000002,2019,2019,T Banton ,ENG
496,7,6,4,4,0,0,4,3 (3ct 0st),0.6659999999999999,2017,2019,JP Behrendorff ,AUS
497,8,8,4,4,0,0,4,1 (1ct 0st),0.5,2006,2014,IR Bell ,ENG
498,9,7,4,4,0,0,4,3 (3ct 0st),0.5710000000000001,2019,2019,TS Bharaj ,DEN
499,9,9,4,4,0,4,0,3 (3ct 0st),0.444,2019,2019,Meet Bhavsar ,KUW
500,4,4,4,3,1,3,0,2 (2ct 0st),1.0,2019,2019,MP Biddappa ,PHI
501,4,4,4,4,0,0,4,1 (1ct 0st),1.0,2019,2019,Bilal Tahir ,KUW
502,5,5,4,3,1,0,3,2 (2ct 0st),0.8,2019,2019,Bilal Zalmai ,Aut
503,4,4,4,4,0,0,4,2 (2ct 0st),1.0,2019,2019,PRP Boissevain ,NL
504,20,20,4,4,0,0,4,1 (1ct 0st),0.2,2005,2010,SE Bond ,NZ
505,20,20,4,4,0,0,4,2 (2ct 0st),0.2,2010,2019,DM Bravo ,WI
506,11,11,4,4,0,0,4,1 (1ct 0st),0.363,2009,2017,NT Broom ,NZ
507,6,6,4,4,0,0,4,1 (1ct 0st),0.6659999999999999,2018,2018,DE Budge ,SCOT
508,12,12,4,4,0,0,4,1 (1ct 0st),0.33299999999999996,2008,2019,RW Chakabva ,ZIM
509,21,21,4,4,0,0,4,1 (1ct 0st),0.19,2010,2019,TL Chatara ,ZIM
510,14,14,4,4,0,0,4,2 (2ct 0st),0.285,2019,2019,JW Chilia ,VAN
511,11,11,4,4,0,0,4,1 (1ct 0st),0.363,2019,2019,K Christie ,HKG
512,9,9,4,4,0,0,4,1 (1ct 0st),0.444,2006,2007,SR Clark ,AUS
513,10,10,4,4,0,0,4,1 (1ct 0st),0.4,2019,2019,DDP D'Silva ,UAE
514,11,11,4,4,0,0,4,2 (2ct 0st),0.363,2019,2019,DAP Darrell ,BMUDA
515,15,14,4,4,0,0,4,2 (2ct 0st),0.285,2008,2013,TN de Grooth ,NL
516,13,13,4,4,0,0,4,1 (1ct 0st),0.307,2015,2019,DM de Silva ,SL
517,8,8,4,4,0,0,4,1 (1ct 0st),0.5,2019,2019,PWH de Silva ,SL
518,11,11,4,4,0,0,4,2 (2ct 0st),0.363,2008,2010,S Dhaniram ,CAN
519,6,6,4,4,0,0,4,2 (2ct 0st),0.6659999999999999,2019,2019,S Dube ,INDIA
520,15,15,4,4,0,0,4,1 (1ct 0st),0.266,2016,2019,Ehsan Khan ,HKG
521,7,7,4,4,0,0,4,3 (3ct 0st),0.5710000000000001,2012,2012,Elias Sunny ,BDESH
522,17,17,4,4,0,0,4,2 (2ct 0st),0.235,2009,2017,GD Elliott ,NZ
523,6,6,4,4,0,0,4,3 (3ct 0st),0.6659999999999999,2016,2016,Fahad Tariq ,UAE
524,13,13,4,4,0,0,4,1 (1ct 0st),0.307,2006,2014,Farhad Reza ,BDESH
525,2,2,4,4,0,0,4,2 (2ct 0st),2.0,2019,2019,O Fournier ,CRC
526,12,12,4,4,0,0,4,1 (1ct 0st),0.33299999999999996,2006,2012,PG Fulton ,NZ
527,3,3,4,4,0,0,4,2 (2ct 0st),1.3330000000000002,2019,2019,PF Gallagher ,Fin
528,9,9,4,4,0,0,4,1 (1ct 0st),0.444,2010,2013,G Goudie ,SCOT
529,8,8,4,4,0,0,4,2 (2ct 0st),0.5,2012,2013,TGJ Gruijters ,NL
530,4,4,4,3,1,3,0,3 (2ct 1st),1.0,2019,2019,K Gupta ,Chile
531,9,7,4,4,0,0,4,2 (2ct 0st),0.5710000000000001,2019,2019,OD Hald ,DEN
532,11,11,4,4,0,0,4,1 (1ct 0st),0.363,2018,2019,Hamza Tahir ,SCOT
533,21,20,4,4,0,0,4,2 (2ct 0st),0.2,2007,2013,RM Haq ,SCOT
534,16,16,4,4,0,0,4,1 (1ct 0st),0.25,2016,2018,TM Head ,AUS
535,8,8,4,4,0,0,4,2 (2ct 0st),0.5,2019,2019,R Hekure ,PNG
536,9,9,4,4,0,0,4,2 (2ct 0st),0.444,2019,2019,DR Hooper ,GUE
537,14,14,4,4,0,0,4,3 (3ct 0st),0.285,2018,2019,Hussain Talat ,PAK
538,5,5,4,4,0,0,4,1 (1ct 0st),0.8,2011,2012,DP Hyatt ,WI
539,2,2,4,2,2,2,0,3 (2ct 1st),2.0,2019,2019,Imran Haider ,ROM
540,14,14,4,4,0,0,4,1 (1ct 0st),0.285,2010,2017,Imrul Kayes ,BDESH
541,14,14,4,4,0,0,4,1 (1ct 0st),0.285,2017,2019,SS Iyer ,INDIA
542,31,31,4,4,0,0,4,1 (1ct 0st),0.129,2006,2011,ST Jayasuriya ,SL
543,8,8,4,4,0,0,4,2 (2ct 0st),0.5,2015,2016,LM Jongwe ,ZIM
544,5,5,4,4,0,0,4,2 (2ct 0st),0.8,2008,2011,SHT Kandamby ,SL
545,6,6,4,4,0,0,4,2 (2ct 0st),0.6659999999999999,2019,2019,G Kansonkho ,MWI
546,10,10,4,4,0,0,4,2 (2ct 0st),0.4,2009,2012,AN Kervezee ,NL
547,13,13,4,4,0,0,4,1 (1ct 0st),0.307,2008,2016,Khalid Latif ,PAK
548,6,6,4,4,0,0,4,1 (1ct 0st),0.6659999999999999,2019,2019,BA King ,WI
549,7,7,4,4,0,0,4,4 (4ct 0st),0.5710000000000001,2019,2019,EB Knowles ,CZK-R
550,9,9,4,4,0,0,4,2 (2ct 0st),0.444,2019,2019,SC Kuggeleijn ,NZ
551,8,8,4,4,0,0,4,2 (2ct 0st),0.5,2019,2019,Kuldeep Lal ,ESP
552,13,13,4,4,0,0,4,1 (1ct 0st),0.307,2012,2012,RE Levi ,SA
553,15,15,4,4,0,0,4,1 (1ct 0st),0.266,2015,2019,N Madziva ,ZIM
554,4,4,4,4,0,0,4,1 (1ct 0st),1.0,2019,2019,MSS Mandy ,Chile
555,11,11,4,4,0,0,4,2 (2ct 0st),0.363,2011,2018,MR Marsh ,AUS
556,13,13,4,4,0,0,4,1 (1ct 0st),0.307,2008,2019,XM Marshall ,USA
557,12,12,4,4,0,0,4,2 (2ct 0st),0.33299999999999996,2015,2019,WP Masakadza ,ZIM
558,5,5,4,4,0,0,4,2 (2ct 0st),0.8,2019,2019,Md Nurul Huda ,Fin
559,3,3,4,4,0,0,4,2 (2ct 0st),1.3330000000000002,2019,2019,AS Mehmi ,
560,48,48,4,4,0,0,4,1 (1ct 0st),0.083,2009,2019,Mohammad Amir ,PAK
561,23,23,4,4,0,0,4,1 (1ct 0st),0.17300000000000001,2007,2013,Mohammad Ashraful ,BDESH
562,16,16,4,3,1,2,1,2 (1ct 1st),0.25,2019,2019,Mohammad Boota ,UAE
563,31,31,4,4,0,0,4,1 (1ct 0st),0.129,2015,2019,Mohammad Naveed ,UAE
564,3,3,4,3,1,3,0,3 (2ct 1st),1.3330000000000002,2019,2019,Muhammad Awais ,
565,8,7,4,4,0,0,4,1 (1ct 0st),0.5710000000000001,2019,2019,GRD Munasinghe ,ITA
566,27,27,4,4,0,0,4,1 (1ct 0st),0.14800000000000002,2009,2017,A Nehra ,INDIA
567,5,5,4,4,0,0,4,2 (2ct 0st),0.8,2019,2019,A Neill ,SCOT
568,8,8,4,4,0,0,4,1 (1ct 0st),0.5,2019,2019,SN Netravalkar ,USA
569,14,14,4,4,0,0,4,1 (1ct 0st),0.285,2019,2019,N Nipiko ,VAN
570,20,20,4,4,0,0,4,1 (1ct 0st),0.2,2010,2017,Noor Ali Zadran ,AFG
571,30,30,4,4,0,0,4,1 (1ct 0st),0.133,2007,2019,AA Obanda ,KENYA
572,11,11,4,4,0,0,4,1 (1ct 0st),0.363,2005,2008,JS Patel ,NZ
573,11,11,4,4,0,0,4,2 (2ct 0st),0.363,2019,2019,RK Paudel ,NEPAL
574,19,19,4,4,0,0,4,2 (2ct 0st),0.21,2016,2019,N Pokana ,PNG
575,20,20,4,4,0,0,4,2 (2ct 0st),0.2,2013,2017,S Prasanna ,SL
576,6,6,4,4,0,0,4,2 (2ct 0st),0.6659999999999999,2014,2016,AT Rayudu ,INDIA
577,18,18,4,4,0,0,4,1 (1ct 0st),0.222,2014,2019,B Regmi ,NEPAL
578,3,3,4,1,3,1,0,2 (1ct 1st),1.3330000000000002,2019,2019,MJ Richardson ,GER
579,18,17,4,4,0,0,4,1 (1ct 0st),0.235,2013,2018,MJG Rippon ,NL
580,14,14,4,4,0,0,4,1 (1ct 0st),0.285,2017,2019,PADLR Sandakan ,SL
581,6,6,4,4,0,0,4,2 (2ct 0st),0.6659999999999999,2016,2016,Saqlain Haider ,UAE
582,16,16,4,4,0,0,4,1 (1ct 0st),0.25,2017,2019,T Shamsi ,SA
583,14,14,4,4,0,0,4,1 (1ct 0st),0.285,2008,2013,I Sharma ,INDIA
584,11,11,4,4,0,0,4,1 (1ct 0st),0.363,2019,2019,B Shikongo ,NAM
585,11,11,4,4,0,0,4,2 (2ct 0st),0.363,2016,2019,Sikander Zulfiqar ,NL
586,7,7,4,4,0,0,4,2 (2ct 0st),0.5710000000000001,2019,2019,Simandeep Singh ,HKG
587,20,20,4,4,0,0,4,1 (1ct 0st),0.2,2013,2016,Sohaib Maqsood ,PAK
588,14,13,4,4,0,0,4,2 (2ct 0st),0.307,2008,2013,ES Szwarczynski ,NL
589,21,21,4,4,0,0,4,1 (1ct 0st),0.19,2014,2016,Tanwir Afzal ,HKG
590,22,21,4,4,0,0,4,1 (1ct 0st),0.19,2008,2019,RN ten Doeschate ,NL
591,12,12,4,4,0,0,4,1 (1ct 0st),0.33299999999999996,2019,2019,C Tommy ,VAN
592,27,27,4,4,0,0,4,2 (2ct 0st),0.14800000000000002,2009,2019,I Udana ,SL
593,14,14,4,4,0,0,4,1 (1ct 0st),0.285,2013,2018,Umar Amin ,PAK
594,14,13,4,4,0,0,4,2 (2ct 0st),0.307,2008,2013,DLS van Bunge ,NL
595,10,9,4,4,0,0,4,2 (2ct 0st),0.444,2007,2010,RR Watson ,SCOT
596,5,5,4,4,0,0,4,2 (2ct 0st),0.8,2008,2009,K Weeraratne ,SL
597,2,2,4,4,0,0,4,3 (3ct 0st),2.0,2011,2011,Yasir Shah ,PAK
598,14,14,4,4,0,0,4,2 (2ct 0st),0.285,2012,2014,Ziaur Rahman ,BDESH
599,17,17,3,3,0,0,3,1 (1ct 0st),0.17600000000000002,2019,2019,MR Adair ,IRE
600,6,6,3,3,0,0,3,1 (1ct 0st),0.5,2019,2019,S Adedeji ,NGA
601,8,8,3,3,0,0,3,1 (1ct 0st),0.375,2018,2019,Afif Hossain ,BDESH
602,12,12,3,3,0,0,3,2 (2ct 0st),0.25,2012,2018,Aftab Alam ,AFG
603,14,14,3,3,0,0,3,1 (1ct 0st),0.214,2018,2019,KK Ahmed ,INDIA
604,4,4,3,1,2,1,0,2 (0ct 2st),0.75,2019,2019,Ainool Haqqiem ,MAL
605,5,5,3,3,0,0,3,1 (1ct 0st),0.6,2019,2019,TP Allen ,USA
606,28,26,3,3,0,0,3,1 (1ct 0st),0.115,2013,2019,Al-Amin Hossain ,BDESH
607,9,9,3,3,0,0,3,2 (2ct 0st),0.33299999999999996,2019,2019,Amir Mangal ,GER
608,19,19,3,3,0,0,3,1 (1ct 0st),0.157,2007,2009,JM Anderson ,ENG
609,4,4,3,3,0,0,3,2 (2ct 0st),0.75,2019,2019,Anowarul Islam ,THAI
610,5,5,3,3,0,0,3,2 (2ct 0st),0.6,2019,2019,P Arrighi ,Arg
611,10,10,3,3,0,0,3,1 (1ct 0st),0.3,2010,2012,Asad Shafiq ,PAK
612,4,4,3,3,0,0,3,2 (2ct 0st),0.75,2005,2006,NJ Astle ,NZ
613,3,3,3,3,0,0,3,1 (1ct 0st),1.0,2016,2019,TD Astle ,NZ
614,3,3,3,2,1,2,0,3 (2ct 1st),1.0,2019,2019,AJ Ayannaike ,NGA
615,4,4,3,3,0,1,2,2 (2ct 0st),0.75,2019,2019,F Baaleri ,Ghana
616,3,3,3,3,0,0,3,1 (1ct 0st),1.0,2019,2019,Babar Ali ,BAH
617,3,3,3,3,0,0,3,3 (3ct 0st),1.0,2019,2019,V Balakrishnan ,Botsw
618,11,11,3,3,0,0,3,1 (1ct 0st),0.272,2019,2019,OGL Bascome ,BMUDA
619,12,12,3,3,0,0,3,1 (1ct 0st),0.25,2019,2019,V Baskaran ,SGP
620,14,14,3,3,0,0,3,1 (1ct 0st),0.214,2019,2019,C Bisson ,JER
621,17,17,3,3,0,0,3,1 (1ct 0st),0.17600000000000002,2019,2019,A Bohara ,NEPAL
622,5,5,3,3,0,0,3,1 (1ct 0st),0.6,2010,2014,DG Brownlie ,NZ
623,19,19,3,3,0,0,3,1 (1ct 0st),0.157,2009,2013,IG Butler ,NZ
624,9,9,3,3,0,0,3,1 (1ct 0st),0.33299999999999996,2019,2019,J Butler ,GUE
625,10,10,3,2,1,2,0,1 (1ct 0st),0.3,2015,2017,C Carter ,HKG
626,2,2,3,3,0,3,0,2 (2ct 0st),1.5,2019,2019,C Chete ,MWI
627,4,4,3,2,1,2,0,1 (1ct 0st),0.75,2019,2019,LA Collado ,GIBR
628,9,8,3,3,0,0,3,1 (1ct 0st),0.375,2008,2010,PC Connell ,IRE
629,15,15,3,3,0,0,3,1 (1ct 0st),0.2,2017,2019,TK Curran ,ENG
630,9,9,3,3,0,0,3,1 (1ct 0st),0.33299999999999996,2018,2019,CJ Dala ,SA
631,5,5,3,2,1,2,0,2 (2ct 0st),0.6,2009,2011,SM Davies ,ENG
632,8,7,3,3,0,0,3,1 (1ct 0st),0.428,2015,2017,CD de Lange ,SCOT
633,9,7,3,3,0,0,3,2 (2ct 0st),0.428,2019,2019,Delawar Khan ,DEN
634,8,8,3,3,0,0,3,1 (1ct 0st),0.375,2018,2019,BFW de Leede ,NL
635,10,10,3,3,0,0,3,1 (1ct 0st),0.3,2009,2019,JL Denly ,ENG
636,11,11,3,3,0,0,3,2 (2ct 0st),0.272,2019,2019,N Dutta ,CAN
637,8,8,3,3,0,0,3,2 (2ct 0st),0.375,2017,2019,LH Ferguson ,NZ
638,18,18,3,3,0,0,3,1 (1ct 0st),0.166,2006,2016,CRD Fernando ,SL
639,4,4,3,3,0,0,3,2 (2ct 0st),0.75,2019,2019,Fiaz Ahmed ,BAH
640,15,14,3,3,0,0,3,1 (1ct 0st),0.214,2019,2019,Fitri Sham ,MAL
641,14,14,3,3,0,0,3,2 (2ct 0st),0.214,2019,2019,SC Getkate ,IRE
642,6,6,3,3,0,0,3,2 (2ct 0st),0.5,2019,2019,D Gim ,NGA
643,19,19,3,3,0,0,3,1 (1ct 0st),0.157,2019,2019,BD Glover ,NL
644,3,3,3,1,2,1,0,2 (1ct 1st),1.0,2019,2019,LF Goncalves ,
645,10,10,3,3,0,0,3,1 (1ct 0st),0.3,2019,2019,Z Groenewald ,NAM
646,12,11,3,3,0,0,3,2 (2ct 0st),0.272,2007,2010,GM Hamilton ,SCOT
647,14,14,3,3,0,0,3,2 (2ct 0st),0.214,2013,2019,Haris Sohail ,PAK
648,11,11,3,3,0,0,3,2 (2ct 0st),0.272,2014,2019,BE Hendricks ,SA
649,11,11,3,3,0,0,3,1 (1ct 0st),0.272,2009,2017,MC Henriques ,AUS
650,12,12,3,3,0,0,3,1 (1ct 0st),0.25,2005,2010,JR Hopes ,AUS
651,5,5,3,3,0,0,3,3 (3ct 0st),0.6,2019,2019,Ibrarul Haq ,Saudi
652,7,7,3,3,0,0,3,1 (1ct 0st),0.428,2010,2011,Imran Farhat ,PAK
653,3,3,3,3,0,0,3,2 (2ct 0st),1.0,2015,2015,Imran Khan ,PAK
654,11,11,3,3,0,0,3,1 (1ct 0st),0.272,2019,2019,Inam-ul-Haq ,QAT
655,6,6,3,3,0,0,3,1 (1ct 0st),0.5,2012,2013,MM Iqbal ,SCOT
656,14,14,3,3,0,0,3,2 (2ct 0st),0.214,2012,2019,Izatullah Dawlatzai ,AFG
657,3,3,3,3,0,0,3,1 (1ct 0st),1.0,2010,2013,Jahurul Islam ,BDESH
658,16,16,3,3,0,0,3,1 (1ct 0st),0.187,2015,2019,GSNFG Jayasuriya ,SL
659,6,6,3,3,0,0,3,1 (1ct 0st),0.5,2019,2019,S Jora ,NEPAL
660,3,3,3,3,0,0,3,2 (2ct 0st),1.0,2019,2019,I Katzarski ,
661,7,7,3,3,0,0,3,2 (2ct 0st),0.428,2019,2019,S Kaveri ,Mex
662,8,8,3,3,0,0,3,1 (1ct 0st),0.375,2005,2007,JM Kemp ,SA
663,18,18,3,3,0,0,3,1 (1ct 0st),0.166,2017,2019,Khurram Nawaz ,OMAN
664,12,12,3,3,0,0,3,2 (2ct 0st),0.25,2019,2019,J Kila ,PNG
665,5,4,3,3,0,0,3,2 (2ct 0st),0.75,2017,2018,AK Kitchen ,NZ
666,11,11,3,3,0,0,3,1 (1ct 0st),0.272,2011,2019,RAS Lakmal ,SL
667,18,18,3,3,0,0,3,1 (1ct 0st),0.166,2018,2019,S Lamichhane ,NEPAL
668,12,12,3,3,0,0,3,1 (1ct 0st),0.25,2019,2019,KS Leverock ,BMUDA
669,18,17,3,3,0,0,3,1 (1ct 0st),0.17600000000000002,2014,2018,CA Lynn ,AUS
670,9,8,3,3,0,0,3,1 (1ct 0st),0.375,2008,2009,WK McCallan ,IRE
671,12,12,3,3,0,0,3,1 (1ct 0st),0.25,2009,2014,R McLaren ,SA
672,8,8,3,3,0,0,3,2 (2ct 0st),0.375,2005,2007,CD McMillan ,NZ
673,3,3,3,3,0,0,3,2 (2ct 0st),1.0,2019,2019,WJ Malinda ,Mald
674,15,15,3,3,0,0,3,2 (2ct 0st),0.2,2008,2016,SE Marsh ,AUS
675,3,3,3,1,2,1,0,2 (0ct 2st),1.0,2012,2012,RD McCann ,IRE
676,4,4,3,1,2,1,0,1 (1ct 0st),0.75,2019,2019,Md Shafiqul Haque ,THAI
677,8,7,3,3,0,0,3,1 (1ct 0st),0.428,2019,2019,GP Meade ,ITA
678,19,18,3,3,0,0,3,1 (1ct 0st),0.166,2015,2019,Mehran Khan ,OMAN
679,15,15,3,3,0,0,3,1 (1ct 0st),0.2,2007,2013,T Mishra ,KENYA
680,11,11,3,3,0,0,3,1 (1ct 0st),0.272,2019,2019,Mohamed Rishwan ,Mald
681,11,11,3,3,0,0,3,1 (1ct 0st),0.272,2006,2010,Mohammad Asif ,PAK
682,14,12,3,3,0,0,3,2 (2ct 0st),0.25,2014,2019,Mohammad Mithun ,BDESH
683,13,13,3,3,0,0,3,1 (1ct 0st),0.23,2017,2019,Mohammad Saifuddin ,BDESH
684,13,13,3,3,0,0,3,1 (1ct 0st),0.23,2010,2016,Mohammad Sami ,PAK
685,5,5,3,3,0,0,3,1 (1ct 0st),0.6,2014,2014,JM Muirhead ,AUS
686,16,16,3,3,0,0,3,1 (1ct 0st),0.187,2018,2019,Mujeeb Ur Rahman ,AFG
687,4,4,3,1,2,1,0,1 (1ct 0st),0.75,2008,2008,AA Mulla ,CAN
688,5,5,3,3,0,0,3,2 (2ct 0st),0.6,2019,2019,T Munyonga ,ZIM
689,14,14,3,3,0,0,3,1 (1ct 0st),0.214,2012,2016,TJ Murtagh ,IRE
690,12,12,3,3,0,0,3,2 (2ct 0st),0.25,2014,2019,Najeeb Tarakai ,AFG
691,3,3,3,3,0,0,3,2 (2ct 0st),1.0,2015,2015,M Nasim Baras ,AFG
692,3,3,3,3,0,0,3,2 (2ct 0st),1.0,2019,2019,A Ndlovu ,ZIM
693,9,9,3,2,1,2,0,1 (1ct 0st),0.33299999999999996,2016,2016,PM Nevill ,AUS
694,10,10,3,2,1,1,1,1 (1ct 0st),0.3,2007,2012,DO Obuya ,KENYA
695,11,11,3,3,0,0,3,1 (1ct 0st),0.272,2010,2013,H Patel ,CAN
696,18,18,3,3,0,0,3,1 (1ct 0st),0.166,2011,2013,SR Patel ,ENG
697,4,4,3,3,0,0,3,2 (2ct 0st),0.75,2011,2012,JL Pattinson ,AUS
698,10,10,3,3,0,0,3,2 (2ct 0st),0.3,2019,2019,Pavandeep Singh ,MAL
699,16,16,3,3,0,0,3,1 (1ct 0st),0.187,2008,2012,RW Price ,ZIM
700,2,2,3,3,0,3,0,2 (2ct 0st),1.5,2019,2019,S Qeshile ,SA
701,21,21,3,3,0,0,3,1 (1ct 0st),0.142,2014,2019,K Rabada ,SA
702,12,12,3,3,0,0,3,1 (1ct 0st),0.25,2018,2019,LN Rajbanshi ,NEPAL
703,10,9,3,3,0,0,3,2 (2ct 0st),0.33299999999999996,2019,2019,Aminuddin Ramly ,MAL
704,3,3,3,3,0,0,3,2 (2ct 0st),1.0,2019,2019,S Ravikumar ,CRC
705,7,7,3,3,0,0,3,2 (2ct 0st),0.428,2009,2010,AJ Redmond ,NZ
706,3,3,3,3,0,0,3,2 (2ct 0st),1.0,2019,2019,KA Reynolds ,Blz
707,8,7,3,3,0,0,3,2 (2ct 0st),0.428,2019,2019,MJ Ross ,ITA
708,11,11,3,3,0,0,3,1 (1ct 0st),0.272,2019,2019,Saad Bin Zafar ,CAN
709,5,5,3,3,0,0,3,1 (1ct 0st),0.6,2019,2019,Sajid Cheema ,Saudi
710,24,24,3,3,0,0,3,1 (1ct 0st),0.125,2007,2010,Salman Butt ,PAK
711,9,9,3,3,0,0,3,1 (1ct 0st),0.33299999999999996,2019,2019,P Sarraf ,NEPAL
712,14,14,3,3,0,0,3,1 (1ct 0st),0.214,2019,2019,BM Scholtz ,NAM
713,24,24,3,3,0,0,3,1 (1ct 0st),0.125,2012,2016,SMSM Senanayake ,SL
714,10,10,3,3,0,0,3,2 (2ct 0st),0.3,2009,2010,Shahzaib Hasan ,PAK
715,3,3,3,3,0,0,3,3 (3ct 0st),1.0,2019,2019,D Sheeli ,KUW
716,2,2,3,3,0,0,3,2 (2ct 0st),1.5,2019,2019,NK Shetty ,Mex
717,6,6,3,3,0,0,3,1 (1ct 0st),0.5,2019,2019,Shiraz Khan ,KUW
718,4,4,3,3,0,0,3,1 (1ct 0st),0.75,2019,2019,P Silas ,Botsw
719,3,3,3,3,0,2,1,2 (2ct 0st),1.0,2005,2007,VS Solanki ,ENG
720,9,9,3,3,0,0,3,1 (1ct 0st),0.33299999999999996,2019,2019,MWR Stokes ,GUE
721,8,8,3,3,0,0,3,1 (1ct 0st),0.375,2007,2010,AO Suji ,KENYA
722,3,3,3,3,0,0,3,1 (1ct 0st),1.0,2019,2019,CR Suryawanshi ,SGP
723,14,14,3,3,0,0,3,1 (1ct 0st),0.214,2005,2009,A Symonds ,AUS
724,21,21,3,3,0,0,3,1 (1ct 0st),0.142,2007,2016,SW Tait ,AUS
725,7,7,3,3,0,0,3,1 (1ct 0st),0.428,2018,2018,SN Thakur ,INDIA
726,4,4,3,3,0,3,0,1 (1ct 0st),0.75,2019,2019,OFJ Tonuu ,Samoa
727,10,10,3,3,0,0,3,1 (1ct 0st),0.3,2016,2018,JD Unadkat ,INDIA
728,8,8,3,3,0,0,3,1 (1ct 0st),0.375,2014,2016,LV van Beek ,NL
729,9,9,3,3,0,0,3,2 (2ct 0st),0.33299999999999996,2018,2019,HE van der Dussen ,SA
730,9,9,3,3,0,0,3,1 (1ct 0st),0.33299999999999996,2010,2015,M Vijay ,INDIA
731,27,26,3,3,0,0,3,1 (1ct 0st),0.115,2015,2019,TP Visee ,NL
732,7,7,3,3,0,0,3,1 (1ct 0st),0.428,2007,2013,AC Voges ,AUS
733,4,4,3,3,0,0,3,1 (1ct 0st),0.75,2019,2019,C Waiswa ,UGA
734,13,13,3,3,0,0,3,1 (1ct 0st),0.23,2019,2019,HR Walsh ,USA
735,5,5,3,3,0,2,1,1 (1ct 0st),0.6,2009,2014,BJ Watling ,NZ
736,7,7,3,3,0,0,3,1 (1ct 0st),0.428,2012,2019,UT Yadav ,INDIA
737,3,3,3,3,0,3,0,1 (1ct 0st),1.0,2019,2019,KJ Young ,Blz
738,4,4,2,2,0,0,2,2 (2ct 0st),0.5,2014,2019,SA Abbott ,AUS
739,5,5,2,2,0,0,2,1 (1ct 0st),0.4,2019,2019,Abdullah Akbarjan ,Aut
740,32,32,2,2,0,0,2,1 (1ct 0st),0.062,2006,2013,Abdul Razzaq ,PAK
741,2,2,2,1,1,1,0,2 (1ct 1st),1.0,2019,2019,Abdul Shakoor ,ROM
742,5,5,2,2,0,0,2,1 (1ct 0st),0.4,2019,2019,AS Abioye ,NGA
743,4,4,2,2,0,0,2,1 (1ct 0st),0.5,2019,2019,IKO Aboagye ,Ghana
744,13,12,2,2,0,0,2,1 (1ct 0st),0.166,2016,2018,Abu Hider ,BDESH
745,8,6,2,1,1,1,0,1 (1ct 0st),0.33299999999999996,2019,2019,Abdul Hashmi ,DEN
746,10,9,2,2,0,0,2,1 (1ct 0st),0.222,2019,2019,Ahmed Faiz ,MAL
747,8,8,2,2,0,0,2,2 (2ct 0st),0.25,2019,2019,CM Akachukwu ,NGA
748,10,10,2,2,0,0,2,1 (1ct 0st),0.2,2012,2013,DI Allan ,KENYA
749,7,7,2,2,0,0,2,1 (1ct 0st),0.285,2007,2011,Alok Kapali ,BDESH
750,1,1,2,1,1,1,0,2 (1ct 1st),2.0,2008,2008,TR Ambrose ,ENG
751,4,4,2,2,0,0,2,1 (1ct 0st),0.5,2015,2016,Amjad Khan ,UAE
752,11,11,2,2,0,0,2,1 (1ct 0st),0.18100000000000002,2019,2019,Amjad Mahboob ,SGP
753,5,5,2,2,0,0,2,1 (1ct 0st),0.4,2019,2019,Amjad Sher ,Fin
754,13,12,2,2,0,1,1,1 (1ct 0st),0.166,2012,2015,Anamul Haque ,BDESH
755,6,5,2,2,0,0,2,1 (1ct 0st),0.4,2019,2019,Anique Uddin ,DEN
756,8,8,2,2,0,0,2,1 (1ct 0st),0.25,2019,2019,R Ankad ,Mex
757,12,11,2,2,0,0,2,1 (1ct 0st),0.18100000000000002,2019,2019,Anwar Arudin ,MAL
758,9,8,2,2,0,0,2,1 (1ct 0st),0.25,2019,2019,Anwar Rahman ,MAL
759,2,2,2,2,0,0,2,2 (2ct 0st),1.0,2019,2019,Areeb Quadir ,Fin
760,12,12,2,2,0,0,2,1 (1ct 0st),0.166,2018,2019,Ashfaq Ahmed ,UAE
761,6,6,2,2,0,0,2,1 (1ct 0st),0.33299999999999996,2019,2019,MNM Aslam ,KUW
762,3,3,2,2,0,0,2,1 (1ct 0st),0.6659999999999999,2019,2019,Asrar Ahmed ,
763,3,3,2,2,0,0,2,2 (2ct 0st),0.6659999999999999,2019,2019,AA Banner ,Blz
764,3,3,2,2,0,0,2,2 (2ct 0st),0.6659999999999999,2019,2019,GG Banner ,Blz
765,9,9,2,2,0,0,2,1 (1ct 0st),0.222,2019,2019,LJ Barker ,GUE
766,5,5,2,2,0,0,2,1 (1ct 0st),0.4,2008,2010,GEF Barnett ,CAN
767,6,6,2,2,0,0,2,1 (1ct 0st),0.33299999999999996,2011,2013,CD Barnwell ,WI
768,4,4,2,2,0,2,0,2 (2ct 0st),0.5,2019,2019,A Bhagwat ,HKG
769,2,2,2,2,0,2,0,1 (1ct 0st),1.0,2019,2019,M Bhanuka ,SL
770,4,4,2,1,1,1,0,1 (1ct 0st),0.5,2012,2012,RA Bhatti ,CAN
771,9,9,2,2,0,0,2,1 (1ct 0st),0.222,2011,2014,DE Bollinger ,AUS
772,2,2,2,2,0,0,2,1 (1ct 0st),1.0,2009,2009,JP Bray ,IRE
773,3,3,2,2,0,0,2,2 (2ct 0st),0.6659999999999999,2006,2007,GB Brent ,ZIM
774,4,4,2,2,0,0,2,1 (1ct 0st),0.5,2019,2019,PR Brown ,ENG
775,4,4,2,1,1,1,0,2 (1ct 1st),0.5,2010,2010,AF Buurman ,NL
776,3,3,2,2,0,2,0,1 (1ct 0st),0.6659999999999999,2019,2019,VD Chandra ,PNM
777,3,3,2,2,0,0,2,1 (1ct 0st),0.6659999999999999,2019,2019,BB Chari ,ZIM
778,7,7,2,2,0,0,2,2 (2ct 0st),0.285,2010,2012,PP Chawla ,INDIA
779,13,13,2,2,0,1,1,1 (1ct 0st),0.153,2010,2015,CK Coventry ,ZIM
780,8,8,2,2,0,0,2,1 (1ct 0st),0.25,2006,2010,KM Dabengwa ,ZIM
781,7,6,2,2,0,0,2,1 (1ct 0st),0.33299999999999996,2019,2019,F Damiao Couana ,Moz
782,2,2,2,2,0,0,2,2 (2ct 0st),1.0,2019,2019,P Danci ,ROM
783,4,4,2,2,0,0,2,1 (1ct 0st),0.5,2008,2008,RR David ,CAN
784,5,5,2,2,0,0,2,1 (1ct 0st),0.4,2008,2010,JM Davison ,CAN
785,6,6,2,2,0,0,2,1 (1ct 0st),0.33299999999999996,2016,2018,LA Dawson ,ENG
786,2,2,2,2,0,0,2,2 (2ct 0st),1.0,2017,2017,TB de Bruyn ,SA
787,8,8,2,2,0,0,2,2 (2ct 0st),0.25,2010,2013,N Deonarine ,WI
788,4,4,2,2,0,0,2,2 (2ct 0st),0.5,2013,2014,AP Devcich ,NZ
789,1,1,2,2,0,0,2,2 (2ct 0st),2.0,2016,2016,R Dhawan ,INDIA
790,17,17,2,2,0,0,2,1 (1ct 0st),0.11699999999999999,2008,2013,GD Drummond ,SCOT
791,5,4,2,2,0,0,2,1 (1ct 0st),0.5,2019,2019,L Emilio ,Moz
792,9,9,2,2,0,0,2,1 (1ct 0st),0.222,2019,2019,GDR Eranga ,CAN
793,9,9,2,2,0,0,2,1 (1ct 0st),0.222,2019,2019,Faran Afzal ,ESP
794,14,14,2,2,0,0,2,1 (1ct 0st),0.142,2019,2019,Fayyaz Butt ,OMAN
795,5,5,2,2,0,0,2,1 (1ct 0st),0.4,2019,2019,A Ferguson ,Arg
796,14,14,2,2,0,0,2,1 (1ct 0st),0.142,2016,2019,N Pradeep ,SL
797,10,10,2,2,0,0,2,1 (1ct 0st),0.2,2019,2019,WIA Fernando ,SL
798,14,14,2,2,0,0,2,1 (1ct 0st),0.142,2019,2019,NJ Ferraby ,JER
799,5,5,2,2,0,0,2,1 (1ct 0st),0.4,2005,2006,SP Fleming ,NZ
800,5,5,2,2,0,0,2,1 (1ct 0st),0.4,2008,2012,DR Flynn ,NZ
801,4,4,2,2,0,0,2,2 (2ct 0st),0.5,2019,2019,JD Freyone ,GIBR
802,2,2,2,2,0,0,2,1 (1ct 0st),1.0,2019,2019,GC Galanis ,
803,4,4,2,2,0,0,2,1 (1ct 0st),0.5,2019,2019,V Ganesan ,GER
804,4,4,2,2,0,0,2,2 (2ct 0st),0.5,2019,2019,CJ Gannon ,USA
805,5,5,2,2,0,0,2,1 (1ct 0st),0.4,2019,2019,Habib Ahmadzai ,Aut
806,22,22,2,2,0,0,2,1 (1ct 0st),0.09,2010,2016,Hamid Hassan ,AFG
807,5,5,2,2,0,0,2,1 (1ct 0st),0.4,2012,2013,Hammad Azam ,PAK
808,6,6,2,2,0,0,2,1 (1ct 0st),0.33299999999999996,2019,2019,Jandu Hamoud ,KUW
809,8,8,2,2,0,0,2,1 (1ct 0st),0.25,2012,2013,AS Hansra ,CAN
810,18,18,2,2,0,0,2,1 (1ct 0st),0.111,2014,2016,Haseeb Amjad ,HKG
811,9,9,2,2,0,0,2,1 (1ct 0st),0.222,2010,2016,JW Hastings ,AUS
812,5,5,2,1,1,1,0,1 (1ct 0st),0.4,2019,2019,C Hauptfleisch ,Caym
813,13,13,2,2,0,0,2,1 (1ct 0st),0.153,2016,2019,Hazratullah Zazai ,AFG
814,5,5,2,2,0,0,2,1 (1ct 0st),0.4,2019,2019,L Hermida ,Mex
815,11,11,2,2,0,0,2,1 (1ct 0st),0.18100000000000002,2019,2019,D Heyliger ,CAN
816,15,15,2,2,0,0,2,1 (1ct 0st),0.133,2012,2013,RM Hira ,NZ
817,4,4,2,2,0,0,2,1 (1ct 0st),0.5,2019,2019,Hirenkumar Patel ,Chile
818,6,6,2,2,0,0,2,1 (1ct 0st),0.33299999999999996,2019,2019,S Hirugade ,Mex
819,4,4,2,2,0,0,2,1 (1ct 0st),0.5,2019,2019,Imran Anwar ,BAH
820,4,4,2,2,0,0,2,2 (2ct 0st),0.5,2019,2019,Imran Ali ,KUW
821,9,9,2,2,0,0,2,1 (1ct 0st),0.222,2010,2012,CA Ingram ,SA
822,8,8,2,2,0,0,2,1 (1ct 0st),0.25,2014,2015,Irfan Ahmed ,HKG
823,4,4,2,2,0,0,2,1 (1ct 0st),0.5,2019,2019,Ismat Ullah ,
824,3,3,2,2,0,2,0,1 (1ct 0st),0.6659999999999999,2019,2019,H Ivanov ,
825,4,4,2,2,0,0,2,1 (1ct 0st),0.5,2007,2007,Joginder Sharma ,INDIA
826,2,2,2,2,0,2,0,1 (1ct 0st),1.0,2005,2006,GO Jones ,ENG
827,3,3,2,2,0,0,2,2 (2ct 0st),0.6659999999999999,2010,2010,MBS Jonkman ,NL
828,13,13,2,2,0,0,2,1 (1ct 0st),0.153,2012,2019,Junaid Siddiqui ,CAN
829,8,8,2,2,0,0,2,1 (1ct 0st),0.25,2019,2019,Junaid Siddique ,UAE
830,4,4,2,2,0,0,2,2 (2ct 0st),0.5,2019,2019,Karweng NG ,PHI
831,2,2,2,2,0,0,2,1 (1ct 0st),1.0,2005,2005,MS Kasprowicz ,AUS
832,3,3,2,2,0,0,2,1 (1ct 0st),0.6659999999999999,2005,2006,SM Katich ,AUS
833,17,17,2,2,0,0,2,1 (1ct 0st),0.11699999999999999,2006,2012,Z Khan ,INDIA
834,3,3,2,2,0,0,2,1 (1ct 0st),0.6659999999999999,2014,2014,Khurram Khan ,UAE
835,3,3,2,2,0,0,2,1 (1ct 0st),0.6659999999999999,2017,2017,M Klinger ,AUS
836,2,2,2,2,0,0,2,2 (2ct 0st),1.0,2008,2008,HGJM Kulatunga ,SL
837,6,6,2,2,0,0,2,1 (1ct 0st),0.33299999999999996,2019,2019,JS Kundi ,KENYA
838,5,5,2,2,0,0,2,1 (1ct 0st),0.4,2019,2019,A Lark ,Aut
839,9,9,2,2,0,0,2,2 (2ct 0st),0.222,2019,2019,LC Le Tissier ,GUE
840,11,11,2,2,0,0,2,1 (1ct 0st),0.18100000000000002,2016,2019,JB Little ,IRE
841,8,8,2,2,0,0,2,1 (1ct 0st),0.25,2006,2016,MF Maharoof ,SL
842,8,7,2,2,0,0,2,1 (1ct 0st),0.285,2019,2019,NA Maiolo ,ITA
843,9,9,2,2,0,0,2,1 (1ct 0st),0.222,2017,2019,DJ Malan ,ENG
844,2,2,2,2,0,0,2,1 (1ct 0st),1.0,2019,2019,JN Malan ,SA
845,3,3,2,2,0,0,2,1 (1ct 0st),0.6659999999999999,2019,2019,A Manousis ,
846,1,1,2,2,0,0,2,2 (2ct 0st),2.0,2008,2008,Mansoor Amjad ,PAK
847,1,1,2,2,0,0,2,2 (2ct 0st),2.0,2011,2011,A Martin ,WI
848,7,7,2,2,0,0,2,1 (1ct 0st),0.285,2010,2013,SW Masakadza ,ZIM
849,2,2,2,2,0,0,2,2 (2ct 0st),1.0,2019,2019,WT Mashinge ,ZIM
850,9,9,2,2,0,0,2,1 (1ct 0st),0.222,2009,2014,NO Miller ,WI
851,9,9,2,2,0,0,2,1 (1ct 0st),0.222,2018,2019,SF Mire ,ZIM
852,5,5,2,2,0,0,2,1 (1ct 0st),0.4,2019,2019,Mohammad Ghazanfar ,HKG
853,3,3,2,2,0,0,2,2 (2ct 0st),0.6659999999999999,2019,2019,Mohammad Naim ,BDESH
854,1,1,2,1,1,1,0,2 (1ct 1st),2.0,2011,2011,Mohammad Salman ,PAK
855,4,4,2,2,0,0,2,1 (1ct 0st),0.5,2019,2019,Mohammed Asghar ,KUW
856,6,6,2,2,0,0,2,1 (1ct 0st),0.33299999999999996,2019,2019,Mohammed Nurji ,MWI
857,7,7,2,2,0,0,2,1 (1ct 0st),0.285,2006,2010,RS Morton ,WI
858,10,10,2,2,0,0,2,1 (1ct 0st),0.2,2019,2019,Muhammad Kashif ,KUW
859,5,5,2,2,0,0,2,2 (2ct 0st),0.4,2019,2019,Muhammad Nadeem ,Saudi
860,4,4,2,2,0,0,2,1 (1ct 0st),0.5,2019,2019,RG Mukasa ,UGA
861,6,6,2,2,0,0,2,1 (1ct 0st),0.33299999999999996,2015,2015,Mukhtar Ahmed ,PAK
862,8,8,2,2,0,0,2,1 (1ct 0st),0.25,2016,2017,J Mulder ,IRE
863,3,3,2,2,0,2,0,1 (1ct 0st),0.6659999999999999,2019,2019,G Murali ,CRC
864,3,3,2,2,0,0,2,2 (2ct 0st),0.6659999999999999,2019,2019,Murid Ekrami ,Belg
865,6,6,2,2,0,0,2,1 (1ct 0st),0.33299999999999996,2018,2018,TK Musakanda ,ZIM
866,5,5,2,2,0,0,2,1 (1ct 0st),0.4,2019,2019,LA Musiani ,Arg
867,13,13,2,2,0,0,2,1 (1ct 0st),0.153,2013,2019,CT Mutombodzi ,ZIM
868,6,6,2,2,0,0,2,1 (1ct 0st),0.33299999999999996,2018,2018,B Muzarabani ,ZIM
869,10,10,2,2,0,0,2,1 (1ct 0st),0.2,2008,2013,Naeem Islam ,BDESH
870,3,3,2,2,0,0,2,2 (2ct 0st),0.6659999999999999,2019,2019,Nanda Kumar ,CRC
871,3,3,2,2,0,0,2,1 (1ct 0st),0.6659999999999999,2019,2019,N Nankov ,
872,4,4,2,2,0,0,2,1 (1ct 0st),0.5,2006,2010,Naved-ul-Hasan ,PAK
873,1,1,2,2,0,2,0,2 (2ct 0st),2.0,2019,2019,Nawazish Jezuli ,Saudi
874,2,2,2,2,0,0,2,1 (1ct 0st),1.0,2019,2019,Najmul Hossain Shanto ,BDESH
875,13,13,2,2,0,0,2,1 (1ct 0st),0.153,2018,2018,Nazmul Islam ,BDESH
876,3,3,2,2,0,0,2,1 (1ct 0st),0.6659999999999999,2019,2019,Nazwan Ismail ,Mald
877,1,1,2,2,0,0,2,2 (2ct 0st),2.0,2016,2016,P Negi ,INDIA
878,4,4,2,2,0,0,2,1 (1ct 0st),0.5,2019,2019,K Nestor ,GIBR
879,2,2,2,0,2,0,0,2 (0ct 2st),1.0,2019,2019,G Nikitas ,
880,2,2,2,2,0,2,0,1 (1ct 0st),1.0,2019,2019,Noor Momand ,Belg
881,3,3,2,2,0,0,2,1 (1ct 0st),0.6659999999999999,2019,2019,F Nsubuga ,UGA
882,10,10,2,2,0,0,2,1 (1ct 0st),0.2,2005,2011,M Ntini ,SA
883,11,11,2,2,0,0,2,1 (1ct 0st),0.18100000000000002,2008,2019,GH O'Brien ,BMUDA
884,8,8,2,2,0,0,2,1 (1ct 0st),0.25,2019,2019,SA Okpe ,NGA
885,10,10,2,2,0,0,2,1 (1ct 0st),0.2,2013,2019,LN Oluoch ,KENYA
886,9,9,2,2,0,2,0,1 (1ct 0st),0.222,2019,2019,AA Onikoyi ,NGA
887,18,18,2,2,0,0,2,1 (1ct 0st),0.111,2012,2019,E Otieno ,KENYA
888,4,4,2,2,0,0,2,1 (1ct 0st),0.5,2008,2008,KO Otieno ,KENYA
889,4,3,2,2,0,0,2,2 (2ct 0st),0.6659999999999999,2018,2019,HC Overdijk ,NL
890,8,8,2,2,0,0,2,2 (2ct 0st),0.25,2019,2019,AM Oyede ,NGA
891,14,14,2,2,0,0,2,1 (1ct 0st),0.142,2013,2016,T Panyangara ,ZIM
892,3,3,2,2,0,0,2,1 (1ct 0st),0.6659999999999999,2019,2019,AE Paraam ,SGP
893,5,5,2,2,0,0,2,2 (2ct 0st),0.4,2014,2015,SD Parry ,ENG
894,24,23,2,2,0,0,2,1 (1ct 0st),0.086,2006,2012,IK Pathan ,INDIA
895,18,18,2,2,0,0,2,1 (1ct 0st),0.111,2018,2019,KMA Paul ,WI
896,6,6,2,2,0,0,2,1 (1ct 0st),0.33299999999999996,2019,2019,T Perera ,Botsw
897,3,3,2,2,0,0,2,2 (2ct 0st),0.6659999999999999,2019,2019,JE Pitcher ,BMUDA
898,3,3,2,2,0,0,2,2 (2ct 0st),0.6659999999999999,2008,2008,OL Pitcher ,BMUDA
899,12,12,2,2,0,0,2,1 (1ct 0st),0.166,2005,2008,SM Pollock ,SA
900,8,7,2,2,0,0,2,1 (1ct 0st),0.285,2007,2010,NS Poonia ,SCOT
901,3,3,2,2,0,0,2,1 (1ct 0st),0.6659999999999999,2017,2017,A Poulose ,OMAN
902,5,5,2,2,0,0,2,1 (1ct 0st),0.4,2007,2007,DBL Powell ,WI
903,19,17,2,2,0,0,2,1 (1ct 0st),0.11699999999999999,2012,2016,AD Poynter ,IRE
904,5,5,2,2,0,0,2,1 (1ct 0st),0.4,2019,2019,A Pusthay ,Fin
905,10,10,2,2,0,0,2,1 (1ct 0st),0.2,2015,2019,Qadeer Ahmed ,UAE
906,8,8,2,2,0,0,2,1 (1ct 0st),0.25,2010,2010,Raees Ahmadzai ,AFG
907,4,4,2,2,0,0,2,1 (1ct 0st),0.5,2019,2019,Raag Kapur ,HKG
908,7,7,2,2,0,0,2,1 (1ct 0st),0.285,2019,2019,S Rakshit ,CZK-R
909,23,23,2,2,0,0,2,1 (1ct 0st),0.086,2007,2015,R Rampaul ,WI
910,5,5,2,2,0,0,2,1 (1ct 0st),0.4,2012,2013,Raza-ur-Rehman ,CAN
911,10,10,2,2,0,0,2,1 (1ct 0st),0.2,2012,2014,Raza Hasan ,PAK
912,6,5,2,2,0,0,2,1 (1ct 0st),0.4,2008,2009,DJ Reekers ,NL
913,3,3,2,2,0,0,2,2 (2ct 0st),0.6659999999999999,2019,2019,GA Reynold ,Blz
914,4,4,2,2,0,0,2,1 (1ct 0st),0.5,2019,2019,LH Rodrigues ,
915,10,10,2,2,0,0,2,1 (1ct 0st),0.2,2019,2019,R Rohan ,SGP
916,5,5,2,2,0,0,2,1 (1ct 0st),0.4,2019,2019,S Rossi ,Arg
917,3,3,2,2,0,0,2,1 (1ct 0st),0.6659999999999999,2019,2019,Saber Zakhil ,Belg
918,5,5,2,2,0,0,2,2 (2ct 0st),0.4,2019,2019,S Saeed ,Mald
919,9,9,2,2,0,0,2,1 (1ct 0st),0.222,2014,2015,Sagar Pun ,NEPAL
920,3,3,2,2,0,0,2,2 (2ct 0st),0.6659999999999999,2018,2018,Sahibzada Farhan ,PAK
921,2,2,2,2,0,0,2,1 (1ct 0st),1.0,2019,2019,J Salazar ,Peru
922,6,6,2,2,0,0,2,2 (2ct 0st),0.33299999999999996,2018,2019,Saqib Zulfiqar ,NL
923,3,3,2,2,0,0,2,1 (1ct 0st),0.6659999999999999,2019,2019,A Sathya ,Mex
924,19,18,2,2,0,0,2,1 (1ct 0st),0.111,2006,2012,V Sehwag ,INDIA
925,4,4,2,2,0,0,2,2 (2ct 0st),0.5,2019,2019,Shaikh Ashraf ,Peru
926,2,2,2,1,1,1,0,2 (1ct 1st),1.0,2012,2012,Shakeel Ansar ,PAK
927,4,4,2,2,0,0,2,1 (1ct 0st),0.5,2019,2019,PH Shamdasani ,Peru
928,9,8,2,2,0,0,2,1 (1ct 0st),0.25,2013,2014,Shamsur Rahman ,BDESH
929,9,9,2,2,0,0,2,1 (1ct 0st),0.222,2018,2019,V Shankar ,INDIA
930,15,15,2,2,0,0,2,1 (1ct 0st),0.133,2006,2010,Shoaib Akhtar ,PAK
931,5,5,2,2,0,0,2,2 (2ct 0st),0.4,2019,2019,Shoaib Ali ,Saudi
932,5,5,2,2,0,0,2,1 (1ct 0st),0.4,2019,2019,Shoaib Qureshi ,Fin
933,8,8,2,2,0,0,2,1 (1ct 0st),0.25,2019,2019,Sidhant Singh ,SGP
934,10,9,2,2,0,0,2,1 (1ct 0st),0.222,2007,2009,RP Singh ,INDIA
935,5,5,2,2,0,0,2,1 (1ct 0st),0.4,2019,2019,L Sipamla ,SA
936,5,5,2,2,0,2,0,1 (1ct 0st),0.4,2019,2019,S Smith ,BMUDA
937,13,12,2,2,0,0,2,1 (1ct 0st),0.166,2018,2019,S Snater ,NL
938,10,10,2,2,0,0,2,1 (1ct 0st),0.2,2012,2015,Sohag Gazi ,BDESH
939,13,13,2,2,0,0,2,1 (1ct 0st),0.153,2015,2019,CA Soper ,PNG
940,10,9,2,2,0,0,2,2 (2ct 0st),0.222,2006,2008,S Sreesanth ,INDIA
941,1,1,2,1,1,1,0,2 (1ct 1st),2.0,2019,2019,H Srinivasan ,GER
942,11,11,2,2,0,0,2,1 (1ct 0st),0.18100000000000002,2009,2012,JH Stander ,SCOT
943,4,4,2,1,1,1,0,2 (1ct 1st),0.5,2019,2019,F Stoman ,PORT
944,6,6,2,2,0,0,2,1 (1ct 0st),0.33299999999999996,2019,2019,DC Stovell ,BMUDA
945,6,6,2,2,0,0,2,1 (1ct 0st),0.33299999999999996,2019,2019,GM Strydom ,Caym
946,8,8,2,2,0,0,2,1 (1ct 0st),0.25,2019,2019,JTS Sumerauer ,JER
947,2,2,2,2,0,0,2,2 (2ct 0st),1.0,2019,2019,K Suttisan ,THAI
948,14,13,2,2,0,0,2,1 (1ct 0st),0.153,2019,2019,Syed Aziz ,MAL
949,4,4,2,2,0,0,2,1 (1ct 0st),0.5,2019,2019,Tahir Dar ,BAH
950,4,4,2,2,0,0,2,1 (1ct 0st),0.5,2019,2019,Tauqeer Hussain ,ESP
951,26,26,2,2,0,0,2,1 (1ct 0st),0.076,2006,2018,WU Tharanga ,SL
952,9,9,2,2,0,0,2,1 (1ct 0st),0.222,2010,2012,J Theron ,SA
953,8,8,2,2,0,0,2,1 (1ct 0st),0.25,2019,2019,RA Thomas ,CAN
954,10,10,2,2,0,0,2,1 (1ct 0st),0.2,2016,2019,GJ Thompson ,IRE
955,6,6,2,2,0,0,2,1 (1ct 0st),0.33299999999999996,2008,2010,T Thushara ,SL
956,10,10,2,2,0,0,2,1 (1ct 0st),0.2,2016,2019,DT Tiripano ,ZIM
957,3,3,2,2,0,0,2,2 (2ct 0st),0.6659999999999999,2011,2012,MK Tiwary ,INDIA
958,17,16,2,2,0,0,2,1 (1ct 0st),0.125,2012,2014,JC Tredwell ,ENG
959,3,3,2,2,0,0,2,2 (2ct 0st),0.6659999999999999,2005,2006,ME Trescothick ,ENG
960,2,2,2,2,0,0,2,1 (1ct 0st),1.0,2019,2019,T Tshose ,Botsw
961,5,5,2,2,0,0,2,1 (1ct 0st),0.4,2019,2019,E Ul Haq ,NOR
962,11,11,2,2,0,0,2,1 (1ct 0st),0.18100000000000002,2019,2019,Umar Adam ,Mald
963,13,12,2,2,0,1,1,1 (1ct 0st),0.166,2007,2015,RV Uthappa ,INDIA
964,5,5,2,2,0,0,2,1 (1ct 0st),0.4,2019,2019,R van der Merwe ,Arg
965,3,3,2,2,0,0,2,1 (1ct 0st),0.6659999999999999,2019,2019,S Vashisht ,ROM
966,4,4,2,2,0,0,2,1 (1ct 0st),0.5,2019,2019,Vichanath Singh ,THAI
967,3,3,2,2,0,0,2,2 (2ct 0st),0.6659999999999999,2019,2019,Vinod Kumar ,ESP
968,11,11,2,2,0,0,2,1 (1ct 0st),0.18100000000000002,2012,2016,BV Vitori ,ZIM
969,10,10,2,2,0,0,2,1 (1ct 0st),0.2,2019,2019,Waheed Ahmed ,UAE
970,1,1,2,2,0,0,2,2 (2ct 0st),2.0,2008,2008,SR Welsh ,CAN
971,18,17,2,2,0,0,2,1 (1ct 0st),0.11699999999999999,2008,2012,AR White ,IRE
972,13,13,2,2,0,0,2,1 (1ct 0st),0.153,2019,2019,CG Williams ,NAM
973,3,3,2,1,1,0,1,1 (1ct 0st),0.6659999999999999,2019,2019,OR Willis ,Caym
974,6,6,2,2,0,0,2,1 (1ct 0st),0.33299999999999996,2019,2019,C Wright ,Caym
975,4,4,2,2,0,0,2,1 (1ct 0st),0.5,2019,2019,Yasar Haroon ,
976,3,3,2,2,0,0,2,2 (2ct 0st),0.6659999999999999,2019,2019,Yusuf Ebrahim ,PNM
977,18,18,2,2,0,0,2,1 (1ct 0st),0.111,2017,2019,Zahoor Khan ,UAE
978,7,7,2,2,0,0,2,1 (1ct 0st),0.285,2008,2018,C Zhuwao ,ZIM
979,6,4,2,2,0,0,2,1 (1ct 0st),0.5,2019,2019,Zishan Shah ,DEN
980,6,6,2,2,0,0,2,1 (1ct 0st),0.33299999999999996,2009,2010,B Zuiderent ,NL
981,5,5,1,1,0,0,1,1 (1ct 0st),0.2,2019,2019,M Abdulla ,MWI
982,6,6,1,0,1,0,0,1 (0ct 1st),0.166,2015,2019,Abdul Shakoor ,UAE
983,5,5,1,1,0,0,1,1 (1ct 0st),0.2,2019,2019,Abdul Wahid ,Saudi
984,7,7,1,1,0,0,1,1 (1ct 0st),0.142,2019,2019,Abraash Khan ,CAN
985,3,3,1,0,1,0,0,1 (0ct 1st),0.33299999999999996,2019,2019,Abrar Bilal ,Aut
986,3,3,1,1,0,0,1,1 (1ct 0st),0.33299999999999996,2018,2018,Abu Jayed ,BDESH
987,4,4,1,1,0,0,1,1 (1ct 0st),0.25,2005,2006,AR Adams ,NZ
988,7,7,1,1,0,0,1,1 (1ct 0st),0.142,2019,2019,VD Adewoye ,NGA
989,1,1,1,0,1,0,0,1 (0ct 1st),1.0,2013,2013,Afsar Zazai ,AFG
990,2,2,1,1,0,0,1,1 (1ct 0st),0.5,2019,2019,GJ Agius ,MALTA
991,2,2,1,1,0,0,1,1 (1ct 0st),0.5,2019,2019,P Agnihotri ,NOR
992,5,3,1,1,0,0,1,1 (1ct 0st),0.33299999999999996,2019,2019,SA Ahmad ,DEN
993,11,11,1,1,0,0,1,1 (1ct 0st),0.09,2019,2019,Ahmed Hassan ,Mald
994,1,1,1,1,0,0,1,1 (1ct 0st),1.0,2011,2011,GW Aldridge ,NZ
995,10,9,1,1,0,0,1,1 (1ct 0st),0.111,2015,2016,Amir Ali ,OMAN
996,5,5,1,1,0,0,1,1 (1ct 0st),0.2,2014,2015,Amjad Ali ,UAE
997,2,2,1,1,0,0,1,1 (1ct 0st),0.5,2019,2019,Anam Mollik ,ITA
998,4,4,1,1,0,0,1,1 (1ct 0st),0.25,2019,2019,Anasim Khan ,BAH
999,5,5,1,1,0,0,1,1 (1ct 0st),0.2,2019,2019,Aqib Iqbal ,Aut
1000,4,4,1,1,0,0,1,1 (1ct 0st),0.25,2019,2019,S Arachchige ,ITA
1001,10,10,1,1,0,0,1,1 (1ct 0st),0.1,2014,2016,Arafat Sunny ,BDESH
1002,8,8,1,1,0,0,1,1 (1ct 0st),0.125,2019,2019,Aritra Dutta ,SGP
1003,2,2,1,1,0,0,1,1 (1ct 0st),0.5,2019,2019,P Arora ,Mex
1004,2,2,1,1,0,0,1,1 (1ct 0st),0.5,2019,2019,U Aryaman Sunil ,SGP
1005,3,3,1,1,0,0,1,1 (1ct 0st),0.33299999999999996,2019,2019,Ashiqullah Said ,Belg
1006,2,2,1,1,0,0,1,1 (1ct 0st),0.5,2019,2019,A Ashokan ,CZK-R
1007,3,3,1,1,0,0,1,1 (1ct 0st),0.33299999999999996,2019,2019,Aslam Mohammad ,
1008,2,2,1,1,0,0,1,1 (1ct 0st),0.5,2019,2019,SK Atai ,PNG
1009,4,4,1,1,0,0,1,1 (1ct 0st),0.25,2019,2019,V Ateak ,Ghana
1010,4,4,1,1,0,0,1,1 (1ct 0st),0.25,2019,2019,Atif Kamal ,LUX
1011,3,3,1,1,0,0,1,1 (1ct 0st),0.33299999999999996,2012,2013,MS Aulakh ,CAN
1012,1,1,1,1,0,0,1,1 (1ct 0st),1.0,2019,2019,Avi Dixit ,SGP
1013,11,11,1,1,0,0,1,1 (1ct 0st),0.09,2019,2019,Awais Malik ,QAT
1014,3,3,1,1,0,0,1,1 (1ct 0st),0.33299999999999996,2019,2019,MO Bacarese ,GIBR
1015,4,4,1,1,0,0,1,1 (1ct 0st),0.25,2019,2019,KS Bagabena ,Ghana
1016,4,4,1,1,0,0,1,1 (1ct 0st),0.25,2019,2019,JD Baker ,Samoa
1017,3,3,1,1,0,0,1,1 (1ct 0st),0.33299999999999996,2019,2019,G Bakiweyem ,Ghana
1018,4,4,1,1,0,0,1,1 (1ct 0st),0.25,2008,2008,WD Balaji Rao ,CAN
1019,8,7,1,1,0,0,1,1 (1ct 0st),0.142,2019,2019,Baljit Singh ,ITA
1020,2,2,1,1,0,0,1,1 (1ct 0st),0.5,2018,2018,JT Ball ,ENG
1021,1,1,1,1,0,1,0,1 (1ct 0st),1.0,2016,2016,CT Bancroft ,AUS
1022,4,4,1,1,0,0,1,1 (1ct 0st),0.25,2006,2009,HMCM Bandara ,SL
1023,1,1,1,1,0,0,1,1 (1ct 0st),1.0,2019,2019,S Bantzas ,
1024,2,2,1,1,0,0,1,1 (1ct 0st),0.5,2010,2011,AB Barath ,WI
1025,4,4,1,1,0,0,1,1 (1ct 0st),0.25,2019,2019,J Barker ,LUX
1026,5,5,1,1,0,0,1,1 (1ct 0st),0.2,2019,2019,P Baron ,Arg
1027,3,3,1,1,0,0,1,1 (1ct 0st),0.33299999999999996,2008,2019,OO Bascome ,BMUDA
1028,2,2,1,1,0,0,1,1 (1ct 0st),0.5,2019,2019,T Bavuma ,SA
1029,3,3,1,1,0,0,1,1 (1ct 0st),0.33299999999999996,2007,2007,RL Bhudia ,KENYA
1030,4,4,1,1,0,0,1,1 (1ct 0st),0.25,2019,2019,SR Bhudia ,KENYA
1031,9,9,1,1,0,0,1,1 (1ct 0st),0.111,2013,2015,Bilawal Bhatti ,PAK
1032,4,4,1,1,0,0,1,1 (1ct 0st),0.25,2010,2012,TR Birt ,AUS
1033,7,7,1,1,0,0,1,1 (1ct 0st),0.142,2011,2019,D Bishoo ,WI
1034,6,5,1,1,0,0,1,1 (1ct 0st),0.2,2007,2008,JAR Blain ,SCOT
1035,3,3,1,1,0,1,0,1 (1ct 0st),0.33299999999999996,2017,2018,TA Blundell ,NZ
1036,3,3,1,1,0,0,1,1 (1ct 0st),0.33299999999999996,2016,2016,SM Boland ,AUS
1037,1,1,1,1,0,0,1,1 (1ct 0st),1.0,2011,2011,SG Borthwick ,ENG
1038,14,14,1,1,0,0,1,1 (1ct 0st),0.071,2006,2010,LE Bosman ,SA
1039,1,1,1,1,0,0,1,1 (1ct 0st),1.0,2006,2006,IDR Bradshaw ,WI
1040,7,6,1,1,0,0,1,1 (1ct 0st),0.166,2012,2014,DR Briggs ,ENG
1041,3,3,1,1,0,0,1,1 (1ct 0st),0.33299999999999996,2019,2019,N Buckle ,GUE
1042,7,6,1,1,0,0,1,1 (1ct 0st),0.166,2019,2019,J Bulele ,Moz
1043,4,4,1,1,0,0,1,1 (1ct 0st),0.25,2019,2019,DE Burgess ,Samoa
1044,1,1,1,1,0,0,1,1 (1ct 0st),1.0,2006,2006,DK Butler ,WI
1045,2,2,1,1,0,0,1,1 (1ct 0st),0.5,2005,2006,CL Cairns ,NZ
1046,2,2,1,1,0,0,1,1 (1ct 0st),0.5,2019,2019,JD Campbell ,WI
1047,3,3,1,1,0,0,1,1 (1ct 0st),0.33299999999999996,2016,2016,RJ Campbell ,HKG
1048,1,1,1,1,0,0,1,1 (1ct 0st),1.0,2014,2014,MA Carberry ,ENG
1049,7,7,1,1,0,0,1,1 (1ct 0st),0.142,2013,2013,NM Carter ,SCOT
1050,3,3,1,1,0,0,1,1 (1ct 0st),0.33299999999999996,2019,2019,P Chandran ,Mex
1051,1,1,1,1,0,0,1,1 (1ct 0st),1.0,2019,2019,N Chejay ,BHU
1052,12,12,1,1,0,0,1,1 (1ct 0st),0.083,2015,2018,TS Chisoro ,ZIM
1053,4,4,1,1,0,0,1,1 (1ct 0st),0.25,2007,2009,AN Cook ,ENG
1054,3,3,1,1,0,0,1,1 (1ct 0st),0.33299999999999996,2019,2019,J Cutinho ,CRC
1055,2,2,1,1,0,0,1,1 (1ct 0st),0.5,2019,2019,DK Dahyabhai Ahir ,PNM
1056,3,3,1,1,0,0,1,1 (1ct 0st),0.33299999999999996,2006,2007,JWM Dalrymple ,ENG
1057,5,5,1,1,0,0,1,1 (1ct 0st),0.2,2019,2019,H Dandapani ,Fin
1058,3,3,1,1,0,0,1,1 (1ct 0st),0.33299999999999996,2019,2019,K Dasan ,
1059,2,2,1,1,0,0,1,1 (1ct 0st),0.5,2008,2013,AS Dean ,CAN
1060,6,6,1,1,0,0,1,1 (1ct 0st),0.166,2012,2015,M de Lange ,SA
1061,4,4,1,1,0,0,1,1 (1ct 0st),0.25,2019,2019,CJ Delany ,GIBR
1062,1,1,1,1,0,0,1,1 (1ct 0st),1.0,2009,2009,SI de Saram ,SL
1063,2,2,1,1,0,0,1,1 (1ct 0st),0.5,2017,2017,PC de Silva ,SL
1064,1,1,1,0,1,0,0,1 (0ct 1st),1.0,2008,2008,Dhiman Ghosh ,BDESH
1065,9,9,1,1,0,0,1,1 (1ct 0st),0.111,2009,2012,AB Dinda ,INDIA
1066,2,2,1,1,0,1,0,1 (1ct 0st),0.5,2019,2019,LA Dunbar ,Serb
1067,4,4,1,1,0,0,1,1 (1ct 0st),0.25,2019,2019,AB Dursak ,TKY
1068,7,7,1,1,0,0,1,1 (1ct 0st),0.142,2019,2019,G Dutta ,Mex
1069,3,3,1,0,1,0,0,1 (0ct 1st),0.33299999999999996,2008,2008,J Edness ,BMUDA
1070,3,3,1,1,0,0,1,1 (1ct 0st),0.33299999999999996,2012,2013,RMS Eranga ,SL
1071,4,4,1,1,0,0,1,1 (1ct 0st),0.25,2019,2019,L Evile ,Samoa
1072,4,4,1,1,0,0,1,1 (1ct 0st),0.25,2019,2019,M Faheem ,THAI
1073,4,4,1,1,0,0,1,1 (1ct 0st),0.25,2019,2019,Faisal Khan ,Saudi
1074,14,14,1,1,0,0,1,1 (1ct 0st),0.071,2016,2019,Fareed Ahmad ,AFG
1075,3,3,1,1,0,0,1,1 (1ct 0st),0.33299999999999996,2016,2016,Farhan Ahmed ,UAE
1076,1,1,1,1,0,0,1,1 (1ct 0st),1.0,2015,2015,Fayyaz Ahmed ,UAE
1077,3,3,1,1,0,0,1,1 (1ct 0st),0.33299999999999996,2009,2009,CJ Ferguson ,AUS
1078,2,2,1,1,0,0,1,1 (1ct 0st),0.5,2008,2008,SE Findlay ,WI
1079,4,4,1,1,0,0,1,1 (1ct 0st),0.25,2019,2019,JA Fitzgerald ,GIBR
1080,1,1,1,1,0,1,0,1 (1ct 0st),1.0,2019,2019,BT Foakes ,ENG
1081,3,3,1,1,0,0,1,1 (1ct 0st),0.33299999999999996,2008,2008,CR Foggo ,BMUDA
1082,10,10,1,1,0,0,1,1 (1ct 0st),0.1,2019,2019,TS Fray ,BMUDA
1083,3,3,1,1,0,0,1,1 (1ct 0st),0.33299999999999996,2019,2019,C Fry ,LUX
1084,3,3,1,1,0,0,1,1 (1ct 0st),0.33299999999999996,2017,2018,R Frylinck ,SA
1085,2,2,1,1,0,0,1,1 (1ct 0st),0.5,2013,2013,ST Gabriel ,WI
1086,6,6,1,1,0,0,1,1 (1ct 0st),0.166,2015,2017,WT Gavera ,PNG
1087,1,1,1,1,0,0,1,1 (1ct 0st),1.0,2019,2019,Gershon Yusuf ,NGA
1088,11,11,1,1,0,0,1,1 (1ct 0st),0.09,2006,2008,MR Gillespie ,NZ
1089,4,4,1,1,0,0,1,1 (1ct 0st),0.25,2019,2019,R Goodwin ,PHI
1090,7,7,1,1,0,0,1,1 (1ct 0st),0.142,2013,2019,JOA Gordon ,CAN
1091,3,3,1,1,0,0,1,1 (1ct 0st),0.33299999999999996,2012,2012,TG Gordon ,CAN
1092,4,4,1,1,0,0,1,1 (1ct 0st),0.25,2019,2019,K Gore ,USA
1093,7,7,1,1,0,0,1,1 (1ct 0st),0.142,2019,2019,H Gori ,CZK-R
1094,1,1,1,1,0,0,1,1 (1ct 0st),1.0,2019,2019,S Goud ,CZK-R
1095,5,5,1,1,0,0,1,1 (1ct 0st),0.2,2014,2015,AM Guruge ,UAE
1096,4,4,1,1,0,0,1,1 (1ct 0st),0.25,2019,2019,Hafez Farooq ,Peru
1097,8,8,1,1,0,0,1,1 (1ct 0st),0.125,2019,2019,OJ Hairs ,SCOT
1098,1,1,1,1,0,0,1,1 (1ct 0st),1.0,2019,2019,Hamza Dar ,ESP
1099,2,2,1,1,0,0,1,1 (1ct 0st),0.5,2005,2006,SJ Harmison ,ENG
1100,3,3,1,1,0,0,1,1 (1ct 0st),0.33299999999999996,2009,2009,NM Hauritz ,AUS
1101,9,9,1,1,0,0,1,1 (1ct 0st),0.111,2005,2007,ML Hayden ,AUS
1102,7,7,1,1,0,0,1,1 (1ct 0st),0.142,2013,2016,JR Hazlewood ,AUS
1103,6,6,1,1,0,0,1,1 (1ct 0st),0.166,2014,2017,MJ Henry ,NZ
1104,5,5,1,1,0,0,1,1 (1ct 0st),0.2,2006,2010,WW Hinds ,WI
1105,15,15,1,1,0,0,1,1 (1ct 0st),0.066,2006,2014,GB Hogg ,AUS
1106,3,3,1,1,0,0,1,1 (1ct 0st),0.33299999999999996,2019,2019,Z Hoque ,THAI
1107,5,5,1,1,0,0,1,1 (1ct 0st),0.2,2007,2008,JM How ,NZ
1108,4,4,1,1,0,0,1,1 (1ct 0st),0.25,2019,2019,MG Hunter ,GIBR
1109,7,6,1,1,0,0,1,1 (1ct 0st),0.166,2019,2019,JJ Huo ,Moz
1110,3,3,1,1,0,0,1,1 (1ct 0st),0.33299999999999996,2019,2019,J Hurley ,Arg
1111,5,5,1,1,0,0,1,1 (1ct 0st),0.2,2019,2019,A Husain ,Arg
1112,3,3,1,1,0,0,1,1 (1ct 0st),0.33299999999999996,2019,2019,GM Hyde ,Blz
1113,3,3,1,1,0,0,1,1 (1ct 0st),0.33299999999999996,2019,2019,Ibrahim Nashath ,Mald
1114,5,5,1,1,0,0,1,1 (1ct 0st),0.2,2019,2019,Ibrahim Rizan ,Mald
1115,3,3,1,1,0,0,1,1 (1ct 0st),0.33299999999999996,2019,2019,Ibrahim Zadran ,AFG
1116,6,6,1,1,0,0,1,1 (1ct 0st),0.166,2019,2019,AF Ifill ,Caym
1117,6,6,1,1,0,0,1,1 (1ct 0st),0.166,2016,2019,Iftikhar Ahmed ,PAK
1118,6,6,1,1,0,0,1,1 (1ct 0st),0.166,2019,2019,Ilyas Ahmed ,KUW
1119,3,3,1,1,0,0,1,1 (1ct 0st),0.33299999999999996,2019,2019,Imran Ashraf ,QAT
1120,11,11,1,1,0,0,1,1 (1ct 0st),0.09,2016,2019,Imran Haider ,UAE
1121,3,3,1,1,0,0,1,1 (1ct 0st),0.33299999999999996,2010,2010,PJ Ingram ,NZ
1122,4,4,1,1,0,0,1,1 (1ct 0st),0.25,2019,2019,DF Jacobs ,THAI
1123,9,9,1,1,0,0,1,1 (1ct 0st),0.111,2015,2017,KM Jadhav ,INDIA
1124,3,3,1,1,0,0,1,1 (1ct 0st),0.33299999999999996,2019,2019,S Jamil ,Belg
1125,4,4,1,1,0,0,1,1 (1ct 0st),0.25,2019,2019,Jasdeep Singh ,USA
1126,5,4,1,1,0,0,1,1 (1ct 0st),0.25,2019,2019,Jaspreet Singh ,ITA
1127,5,5,1,1,0,0,1,1 (1ct 0st),0.2,2008,2008,K Jethi ,CAN
1128,7,5,1,1,0,0,1,1 (1ct 0st),0.2,2019,2019,J Jojo ,DEN
1129,8,8,1,1,0,0,1,1 (1ct 0st),0.125,2019,2019,MO Jones ,BMUDA
1130,5,4,1,1,0,0,1,1 (1ct 0st),0.25,2010,2012,NG Jones ,IRE
1131,2,2,1,1,0,0,1,1 (1ct 0st),0.5,2018,2018,C Jonker ,SA
1132,7,7,1,1,0,0,1,1 (1ct 0st),0.142,2007,2012,Junaid Siddique ,BDESH
1133,7,6,1,1,0,0,1,1 (1ct 0st),0.166,2019,2019,Kaleem Shah ,Moz
1134,12,12,1,1,0,0,1,1 (1ct 0st),0.083,2007,2010,JK Kamande ,KENYA
1135,3,3,1,1,0,0,1,1 (1ct 0st),0.33299999999999996,2014,2014,Kamran Shazad ,UAE
1136,7,5,1,1,0,0,1,1 (1ct 0st),0.2,2015,2019,TE Kane ,IRE
1137,2,2,1,1,0,0,1,1 (1ct 0st),0.5,2010,2010,S Keshvani ,CAN
1138,1,1,1,1,0,0,1,1 (1ct 0st),1.0,2009,2009,RWT Key ,ENG
1139,2,2,1,1,0,0,1,1 (1ct 0st),0.5,2019,2019,N Khanna ,MALTA
1140,5,5,1,0,1,0,0,1 (0ct 1st),0.2,2019,2019,Khizer Ahmed ,NOR
1141,4,4,1,1,0,0,1,1 (1ct 0st),0.25,2019,2019,N Khosla ,MALTA
1142,4,4,1,1,0,0,1,1 (1ct 0st),0.25,2010,2010,Khurram Chohan ,CAN
1143,3,3,1,0,1,0,0,1 (0ct 1st),0.33299999999999996,2019,2019,TCR Kimber ,GUE
1144,5,5,1,1,0,0,1,1 (1ct 0st),0.2,2019,2019,NR Kirton ,CAN
1145,6,6,1,1,0,0,1,1 (1ct 0st),0.166,2008,2013,RK Kleinveldt ,SA
1146,4,4,1,1,0,0,1,1 (1ct 0st),0.25,2019,2019,Kuldeep Singh ,PHI
1147,10,10,1,1,0,0,1,1 (1ct 0st),0.1,2008,2012,P Kumar ,INDIA
1148,4,4,1,1,0,0,1,1 (1ct 0st),0.25,2019,2019,R Kumar ,ROM
1149,3,3,1,1,0,0,1,1 (1ct 0st),0.33299999999999996,2019,2019,UKPW Kumaranayaka ,KUW
1150,1,1,1,1,0,0,1,1 (1ct 0st),1.0,2019,2019,A Lagos ,
1151,3,3,1,1,0,0,1,1 (1ct 0st),0.33299999999999996,2019,2019,H Lakov ,
1152,9,9,1,1,0,0,1,1 (1ct 0st),0.111,2005,2010,CK Langeveldt ,SA
1153,3,3,1,1,0,0,1,1 (1ct 0st),0.33299999999999996,2009,2013,B Laughlin ,AUS
1154,2,2,1,1,0,0,1,1 (1ct 0st),0.5,2005,2007,J Lewis ,ENG
1155,2,2,1,1,0,0,1,1 (1ct 0st),0.5,2006,2006,ML Lewis ,AUS
1156,1,1,1,1,0,0,1,1 (1ct 0st),1.0,2008,2008,RN Lewis ,WI
1157,6,5,1,1,0,0,1,1 (1ct 0st),0.2,2019,2019,NCK Liyanage ,MAL
1158,2,2,1,1,0,0,1,1 (1ct 0st),0.5,2012,2012,KS Lokuarachchi ,SL
1159,2,2,1,1,0,0,1,1 (1ct 0st),0.5,2019,2019,J Long ,PHI
1160,6,6,1,1,0,0,1,1 (1ct 0st),0.166,2019,2019,T Lungameni ,NAM
1161,2,2,1,1,0,0,1,1 (1ct 0st),0.5,2005,2005,GD McGrath ,AUS
1162,6,6,1,1,0,0,1,1 (1ct 0st),0.166,2013,2018,NJ Maddinson ,AUS
1163,4,4,1,1,0,0,1,1 (1ct 0st),0.25,2007,2007,DL Maddy ,ENG
1164,1,1,1,1,0,0,1,1 (1ct 0st),1.0,2018,2018,Mahedi Hasan ,BDESH
1165,2,2,1,1,0,0,1,1 (1ct 0st),0.5,2019,2019,Mahmad Data ,PNM
1166,3,3,1,1,0,0,1,1 (1ct 0st),0.33299999999999996,2019,2019,S Mahmood ,ENG
1167,4,4,1,1,0,0,1,1 (1ct 0st),0.25,2006,2009,SI Mahmood ,ENG
1168,3,3,1,1,0,0,1,1 (1ct 0st),0.33299999999999996,2008,2008,GI Maiden ,SCOT
1169,4,4,1,1,0,0,1,1 (1ct 0st),0.25,2019,2019,BF Mailata ,Samoa
1170,4,2,1,1,0,0,1,1 (1ct 0st),0.5,2015,2016,GT Main ,SCOT
1171,6,6,1,1,0,0,1,1 (1ct 0st),0.166,2019,2019,D Maisuria ,Botsw
1172,4,4,1,1,0,0,1,1 (1ct 0st),0.25,2019,2019,A Makesh ,KUW
1173,2,2,1,1,0,0,1,1 (1ct 0st),0.5,2015,2015,AK Mandal ,NEPAL
1174,3,3,1,1,0,0,1,1 (1ct 0st),0.33299999999999996,2016,2016,Mandeep Singh ,INDIA
1175,6,6,1,1,0,0,1,1 (1ct 0st),0.166,2019,2019,P Manning ,Caym
1176,2,2,1,1,0,0,1,1 (1ct 0st),0.5,2019,2019,AK Markram ,SA
1177,3,3,1,1,0,0,1,1 (1ct 0st),0.33299999999999996,2005,2006,HJH Marshall ,NZ
1178,3,3,1,1,0,0,1,1 (1ct 0st),0.33299999999999996,2019,2019,OM Marshall ,Peru
1179,6,6,1,1,0,0,1,1 (1ct 0st),0.166,2007,2008,CS Martin ,NZ
1180,4,4,1,1,0,0,1,1 (1ct 0st),0.25,2005,2006,DR Martyn ,AUS
1181,2,2,1,1,0,0,1,1 (1ct 0st),0.5,2019,2019,I Master ,Botsw
1182,3,3,1,1,0,0,1,1 (1ct 0st),0.33299999999999996,2011,2012,GE Mathurin ,WI
1183,3,3,1,1,0,0,1,1 (1ct 0st),0.33299999999999996,2018,2018,B Mavuta ,ZIM
1184,1,1,1,1,0,0,1,1 (1ct 0st),1.0,2019,2019,M Meade ,Chile
1185,2,2,1,1,0,0,1,1 (1ct 0st),0.5,2012,2012,SC Meaker ,ENG
1186,3,3,1,1,0,1,0,1 (1ct 0st),0.33299999999999996,2019,2019,J Mees ,LUX
1187,4,4,1,1,0,0,1,1 (1ct 0st),0.25,2018,2019,PHKD Mendis ,SL
1188,5,5,1,1,0,0,1,1 (1ct 0st),0.2,2019,2019,CAJ Meschede ,GER
1189,2,2,1,1,0,0,1,1 (1ct 0st),0.5,2012,2012,KO Meth ,ZIM
1190,4,4,1,1,0,0,1,1 (1ct 0st),0.25,2019,2019,Mian Mehmood ,PORT
1191,4,4,1,1,0,0,1,1 (1ct 0st),0.25,2019,2019,AJ Michael ,Samoa
1192,5,5,1,1,0,0,1,1 (1ct 0st),0.2,2016,2018,TS Mills ,ENG
1193,10,10,1,1,0,0,1,1 (1ct 0st),0.1,2010,2017,A Mishra ,INDIA
1194,3,3,1,1,0,0,1,1 (1ct 0st),0.33299999999999996,2019,2019,P Mishra ,
1195,3,3,1,1,0,0,1,1 (1ct 0st),0.33299999999999996,2019,2019,K Modise ,Botsw
1196,22,22,1,1,0,0,1,1 (1ct 0st),0.045,2012,2019,Mohammad Irfan ,PAK
1197,3,3,1,1,0,0,1,1 (1ct 0st),0.33299999999999996,2010,2010,Mohammad Kashif ,NL
1198,20,20,1,1,0,0,1,1 (1ct 0st),0.05,2015,2017,Mohammad Shahzad ,UAE
1199,3,3,1,1,0,0,1,1 (1ct 0st),0.33299999999999996,2015,2015,Mohammad Tauqir ,UAE
1200,3,3,1,1,0,0,1,1 (1ct 0st),0.33299999999999996,2006,2010,Mohammad Yousuf ,PAK
1201,9,9,1,1,0,0,1,1 (1ct 0st),0.111,2017,2018,JN Mohammed ,WI
1202,3,3,1,1,0,0,1,1 (1ct 0st),0.33299999999999996,2016,2017,Mohammed Qasim ,UAE
1203,3,3,1,1,0,0,1,1 (1ct 0st),0.33299999999999996,2017,2018,Mohammed Siraj ,INDIA
1204,4,3,1,1,0,0,1,1 (1ct 0st),0.33299999999999996,2008,2008,HJC Mol ,NL
1205,6,6,1,1,0,0,1,1 (1ct 0st),0.166,2012,2014,Mominul Haque ,BDESH
1206,1,1,1,1,0,0,1,1 (1ct 0st),1.0,2006,2006,D Mongia ,INDIA
1207,7,7,1,1,0,0,1,1 (1ct 0st),0.142,2019,2019,M Mooketsi ,Botsw
1208,7,7,1,1,0,0,1,1 (1ct 0st),0.142,2019,2019,Mudassar Muhammad ,GER
1209,10,9,1,1,0,0,1,1 (1ct 0st),0.111,2019,2019,Muhamad Syahadat ,MAL
1210,1,1,1,1,0,0,1,1 (1ct 0st),1.0,2019,2019,Muhammad Amir ,MAL
1211,2,2,1,1,0,0,1,1 (1ct 0st),0.5,2019,2019,Muhammad Asjed ,ESP
1212,9,9,1,1,0,0,1,1 (1ct 0st),0.111,2016,2016,Muhammad Kaleem ,UAE
1213,5,5,1,1,0,1,0,1 (1ct 0st),0.2,2019,2019,Muhammad Khurram ,MWI
1214,5,5,1,1,0,0,1,1 (1ct 0st),0.2,2019,2019,Muhammad Naeem ,Saudi
1215,4,4,1,1,0,0,1,1 (1ct 0st),0.25,2019,2019,Muhammad Saleem ,
1216,4,4,1,1,0,0,1,1 (1ct 0st),0.25,2014,2015,JK Mukhiya ,NEPAL
1217,13,13,1,1,0,0,1,1 (1ct 0st),0.076,2012,2017,EMDY Munaweera ,SL
1218,5,5,1,1,0,0,1,1 (1ct 0st),0.2,2019,2019,GBW Munaweera ,QAT
1219,2,2,1,1,0,0,1,1 (1ct 0st),0.5,2014,2014,Munir Dar ,HKG
1220,12,12,1,1,0,0,1,1 (1ct 0st),0.083,2006,2010,M Muralitharan ,SL
1221,4,4,1,1,0,1,0,1 (1ct 0st),0.25,2013,2013,D Murphy ,SCOT
1222,2,2,1,1,0,0,1,1 (1ct 0st),0.5,2019,2019,Musawar Shah ,QAT
1223,5,5,1,1,0,0,1,1 (1ct 0st),0.2,2013,2014,N M'shangwe ,ZIM
1224,3,3,1,1,0,0,1,1 (1ct 0st),0.33299999999999996,2019,2019,AK Muslar ,Blz
1225,7,7,1,1,0,0,1,1 (1ct 0st),0.142,2019,2019,Muslim Yar ,GER
1226,9,9,1,1,0,0,1,1 (1ct 0st),0.111,2015,2016,T Muzarabani ,ZIM
1227,3,3,1,1,0,0,1,1 (1ct 0st),0.33299999999999996,2019,2019,M Mwamadi ,MWI
1228,4,4,1,1,0,0,1,1 (1ct 0st),0.25,2019,2019,Najjam Shahzad ,PORT
1229,4,4,1,1,0,0,1,1 (1ct 0st),0.25,2019,2019,DM Nakrani ,UGA
1230,9,9,1,1,0,0,1,1 (1ct 0st),0.111,2019,2019,W Nalisa ,VAN
1231,17,17,1,1,0,0,1,1 (1ct 0st),0.057999999999999996,2009,2010,DP Nannes ,AUS
1232,10,10,1,1,0,0,1,1 (1ct 0st),0.1,2017,2019,Naseem Khushi ,OMAN
1233,5,5,1,1,0,0,1,1 (1ct 0st),0.2,2019,2019,A Nathwani ,Aut
1234,3,3,1,1,0,0,1,1 (1ct 0st),0.33299999999999996,2019,2019,A Natubhai Ahir ,PNM
1235,7,7,1,1,0,0,1,1 (1ct 0st),0.142,2019,2019,Naveed Ahmed ,CZK-R
1236,2,2,1,1,0,0,1,1 (1ct 0st),0.5,2019,2019,Nazakat Ali ,NOR
1237,7,7,1,1,0,0,1,1 (1ct 0st),0.142,2019,2019,Nazril Rahman ,MAL
1238,2,2,1,1,0,0,1,1 (1ct 0st),0.5,2005,2007,A Nel ,SA
1239,10,9,1,1,0,0,1,1 (1ct 0st),0.111,2007,2010,JD Nel ,SCOT
1240,7,7,1,1,0,0,1,1 (1ct 0st),0.142,2017,2018,L Ngidi ,SA
1241,1,1,1,0,1,0,0,1 (0ct 1st),1.0,2007,2007,PA Nixon ,ENG
1242,1,1,1,1,0,0,1,1 (1ct 0st),1.0,2019,2019,L Nussbaumer ,GUE
1243,12,12,1,1,0,0,1,1 (1ct 0st),0.083,2019,2019,SH Obed ,VAN
1244,2,2,1,1,0,0,1,1 (1ct 0st),0.5,2019,2019,E Ochieng ,KENYA
1245,6,6,1,1,0,0,1,1 (1ct 0st),0.166,2009,2010,PP Ojha ,INDIA
1246,7,7,1,1,0,0,1,1 (1ct 0st),0.142,2010,2011,SNJ O'Keefe ,AUS
1247,8,8,1,1,0,0,1,1 (1ct 0st),0.125,2019,2019,IO Okpe ,NGA
1248,2,2,1,1,0,0,1,1 (1ct 0st),0.5,2019,2019,R Olipa ,UGA
1249,2,2,1,1,0,0,1,1 (1ct 0st),0.5,2019,2019,Omar Hayat ,DEN
1250,4,4,1,1,0,1,0,1 (1ct 0st),0.25,2019,2019,A Otwani ,UGA
1251,3,3,1,1,0,0,1,1 (1ct 0st),0.33299999999999996,2008,2008,SD Outerbridge ,BMUDA
1252,4,4,1,1,0,0,1,1 (1ct 0st),0.25,2019,2019,E Packard ,GIBR
1253,2,2,1,1,0,0,1,1 (1ct 0st),0.5,2015,2015,K Pala ,PNG
1254,4,4,1,1,0,0,1,1 (1ct 0st),0.25,2019,2019,I Pandey ,NEPAL
1255,8,8,1,1,0,0,1,1 (1ct 0st),0.125,2019,2019,NMS Param ,SGP
1256,2,2,1,1,0,1,0,1 (1ct 0st),0.5,2011,2011,PA Patel ,INDIA
1257,2,2,1,1,0,0,1,1 (1ct 0st),0.5,2019,2019,RN Patel ,KENYA
1258,8,8,1,1,0,0,1,1 (1ct 0st),0.125,2017,2018,D Paterson ,SA
1259,4,4,1,1,0,0,1,1 (1ct 0st),0.25,2019,2019,C Pengkumta ,THAI
1260,6,6,1,1,0,0,1,1 (1ct 0st),0.166,2013,2019,AK Perera ,SL
1261,2,2,1,1,0,0,1,1 (1ct 0st),0.5,2019,2019,SL Perera ,Ghana
1262,1,1,1,1,0,0,1,1 (1ct 0st),1.0,2008,2008,WKD Perkins ,WI
1263,2,2,1,1,0,0,1,1 (1ct 0st),0.5,2019,2019,J Perman ,ESP
1264,2,2,1,1,0,0,1,1 (1ct 0st),0.5,2010,2010,AN Petersen ,SA
1265,7,7,1,1,0,0,1,1 (1ct 0st),0.142,2007,2007,VD Philander ,SA
1266,8,8,1,1,0,0,1,1 (1ct 0st),0.125,2018,2019,K Pierre ,WI
1267,6,6,1,1,0,0,1,1 (1ct 0st),0.166,2019,2019,R Pillai ,GER
1268,1,1,1,1,0,0,1,1 (1ct 0st),1.0,2019,2019,R Pisal ,ROM
1269,5,5,1,1,0,0,1,1 (1ct 0st),0.2,2019,2019,S Pokhriyal ,CZK-R
1270,1,1,1,1,0,0,1,1 (1ct 0st),1.0,2014,2014,KOA Powell ,WI
1271,1,1,1,1,0,0,1,1 (1ct 0st),1.0,2009,2009,M Pushpakumara ,SL
1272,4,4,1,1,0,0,1,1 (1ct 0st),0.25,2019,2019,A Rangaswamy ,Botsw
1273,5,5,1,1,0,0,1,1 (1ct 0st),0.2,2008,2010,Raqibul Hasan ,BDESH
1274,5,5,1,1,0,0,1,1 (1ct 0st),0.2,2019,2019,Raza Iqbal ,NOR
1275,1,1,1,1,0,1,0,1 (1ct 0st),1.0,2006,2006,CMW Read ,ENG
1276,1,1,1,1,0,0,1,1 (1ct 0st),1.0,2009,2009,FL Reifer ,WI
1277,9,9,1,1,0,0,1,1 (1ct 0st),0.111,2015,2019,JB Reva ,PNG
1278,11,11,1,1,0,0,1,1 (1ct 0st),0.09,2008,2012,KAJ Roach ,WI
1279,2,2,1,1,0,0,1,1 (1ct 0st),0.5,2008,2008,IH Romaine ,BMUDA
1280,27,26,1,1,0,0,1,1 (1ct 0st),0.038,2009,2018,Rubel Hossain ,BDESH
1281,8,8,1,1,0,0,1,1 (1ct 0st),0.125,2016,2018,Rumman Raees ,PAK
1282,2,2,1,1,0,0,1,1 (1ct 0st),0.5,2009,2009,RJMGM Rupasinghe ,SL
1283,3,3,1,1,0,0,1,1 (1ct 0st),0.33299999999999996,2019,2019,GR Russ ,PHI
1284,8,8,1,1,0,0,1,1 (1ct 0st),0.125,2013,2019,HD Rutherford ,NZ
1285,3,3,1,1,0,0,1,1 (1ct 0st),0.33299999999999996,2018,2019,SE Rutherford ,WI
1286,3,3,1,1,0,0,1,1 (1ct 0st),0.33299999999999996,2014,2014,Saad Nasim ,PAK
1287,2,2,1,1,0,0,1,1 (1ct 0st),0.5,2019,2019,VM Sachdev ,PNM
1288,3,3,1,1,0,0,1,1 (1ct 0st),0.33299999999999996,2019,2019,Sadeeq Khan ,ROM
1289,7,7,1,1,0,0,1,1 (1ct 0st),0.142,2019,2019,Sahir Naqash ,GER
1290,5,5,1,1,0,0,1,1 (1ct 0st),0.2,2019,2019,NA Saini ,INDIA
1291,1,1,1,1,0,0,1,1 (1ct 0st),1.0,2013,2013,Sajedul Islam ,BDESH
1292,7,7,1,1,0,0,1,1 (1ct 0st),0.142,2008,2010,AM Samad ,CAN
1293,1,1,1,1,0,0,1,1 (1ct 0st),1.0,2015,2015,SV Samson ,INDIA
1294,10,10,1,1,0,0,1,1 (1ct 0st),0.1,2019,2019,R Sandaruwan ,KUW
1295,8,8,1,1,0,0,1,1 (1ct 0st),0.125,2017,2017,JRMVB Sanjaya ,SL
1296,12,12,1,1,0,0,1,1 (1ct 0st),0.083,2011,2014,K Santokie ,WI
1297,2,2,1,1,0,0,1,1 (1ct 0st),0.5,2019,2019,Saqlain Arshad ,QAT
1298,2,2,1,1,0,0,1,1 (1ct 0st),0.5,2019,2019,M Sarenac ,Serb
1299,3,3,1,1,0,0,1,1 (1ct 0st),0.33299999999999996,2019,2019,A Sarma ,GER
1300,5,5,1,1,0,0,1,1 (1ct 0st),0.2,2019,2019,MM Sarwar ,KUW
1301,2,2,1,1,0,0,1,1 (1ct 0st),0.5,2019,2019,I Sawmy ,DEN
1302,4,4,1,1,0,0,1,1 (1ct 0st),0.25,2015,2019,Sayed Shirzad ,AFG
1303,4,4,1,1,0,0,1,1 (1ct 0st),0.25,2007,2007,CP Schofield ,ENG
1304,2,2,1,1,0,0,1,1 (1ct 0st),0.5,2019,2019,Shaffeq Muhammad ,
1305,17,17,1,1,0,0,1,1 (1ct 0st),0.057999999999999996,2010,2019,Shafiul Islam ,BDESH
1306,10,10,1,1,0,0,1,1 (1ct 0st),0.1,2018,2019,Shaheen Shah Afridi ,PAK
1307,3,3,1,1,0,0,1,1 (1ct 0st),0.33299999999999996,2019,2019,Shaheryar Butt ,Belg
1308,9,9,1,1,0,0,1,1 (1ct 0st),0.111,2016,2019,Shahid Wasif ,HKG
1309,1,1,1,1,0,0,1,1 (1ct 0st),1.0,2006,2006,Shahriar Nafees ,BDESH
1310,3,3,1,1,0,0,1,1 (1ct 0st),0.33299999999999996,2010,2011,A Shahzad ,ENG
1311,3,3,1,1,0,0,1,1 (1ct 0st),0.33299999999999996,2019,2019,Shamsudheen Purat ,Saudi
1312,8,8,1,1,0,0,1,1 (1ct 0st),0.125,2013,2018,JNK Shannon ,IRE
1313,8,8,1,1,0,0,1,1 (1ct 0st),0.125,2015,2019,Sharafuddin Ashraf ,AFG
1314,8,8,1,1,0,0,1,1 (1ct 0st),0.125,2014,2015,MM Sharma ,INDIA
1315,2,2,1,1,0,0,1,1 (1ct 0st),0.5,2014,2014,V Shetty ,UAE
1316,4,4,1,1,0,0,1,1 (1ct 0st),0.25,2008,2008,Shoaib Khan jnr ,PAK
1317,5,5,1,1,0,0,1,1 (1ct 0st),0.2,2016,2016,Shuvagata Hom ,BDESH
1318,2,2,1,1,0,0,1,1 (1ct 0st),0.5,2014,2014,EHSN Silva ,UAE
1319,2,2,1,1,0,0,1,1 (1ct 0st),0.5,2019,2019,KRP Silva ,USA
1320,3,3,1,1,0,0,1,1 (1ct 0st),0.33299999999999996,2019,2019,M Simpson-Parker ,Aut
1321,2,2,1,1,0,0,1,1 (1ct 0st),0.5,2019,2019,J Singye ,BHU
1322,6,6,1,1,0,0,1,1 (1ct 0st),0.166,2007,2009,DS Smith ,WI
1323,5,5,1,0,1,0,0,1 (0ct 1st),0.2,2010,2012,SJS Smith ,SCOT
1324,6,5,1,1,0,1,0,1 (1ct 0st),0.2,2008,2009,J Smits ,NL
1325,8,8,1,1,0,0,1,1 (1ct 0st),0.125,2017,2018,JT Smuts ,SA
1326,1,1,1,1,0,0,1,1 (1ct 0st),1.0,2007,2007,JN Snape ,ENG
1327,4,4,1,1,0,0,1,1 (1ct 0st),0.25,2017,2018,CB Sole ,SCOT
1328,4,4,1,1,0,0,1,1 (1ct 0st),0.25,2019,2019,A Srivastav ,Chile
1329,7,7,1,1,0,0,1,1 (1ct 0st),0.142,2019,2019,ACF Stokes ,GUE
1330,4,4,1,1,0,0,1,1 (1ct 0st),0.25,2005,2009,AJ Strauss ,ENG
1331,4,3,1,1,0,0,1,1 (1ct 0st),0.33299999999999996,2008,2008,R Strydom ,IRE
1332,3,3,1,1,0,0,1,1 (1ct 0st),0.33299999999999996,2015,2019,Sufyan Mehmood ,OMAN
1333,2,1,1,1,0,0,1,1 (1ct 0st),1.0,2019,2019,P Syafiq Ali ,MAL
1334,8,8,1,1,0,0,1,1 (1ct 0st),0.125,2007,2008,Syed Rasel ,BDESH
1335,5,5,1,1,0,0,1,1 (1ct 0st),0.2,2016,2017,Tanveer Ahmed ,HKG
1336,19,17,1,1,0,0,1,1 (1ct 0st),0.057999999999999996,2014,2018,Taskin Ahmed ,BDESH
1337,7,7,1,1,0,0,1,1 (1ct 0st),0.142,2019,2019,P Taylor ,CZK-R
1338,6,6,1,1,0,0,1,1 (1ct 0st),0.166,2019,2019,T Taylor ,Caym
1339,1,1,1,1,0,0,1,1 (1ct 0st),1.0,2006,2006,SR Tendulkar ,INDIA
1340,1,1,1,1,0,0,1,1 (1ct 0st),1.0,2016,2016,SP Terry ,IRE
1341,3,3,1,0,1,0,0,1 (0ct 1st),0.33299999999999996,2009,2013,DC Thomas ,WI
1342,2,2,1,1,0,0,1,1 (1ct 0st),0.5,2019,2019,S Tobgay ,BHU
1343,1,1,1,1,0,0,1,1 (1ct 0st),1.0,2009,2009,GC Tonge ,WI
1344,6,6,1,1,0,0,1,1 (1ct 0st),0.166,2015,2016,RJW Topley ,ENG
1345,3,3,1,1,0,0,1,1 (1ct 0st),0.33299999999999996,2019,2019,A Tripathi ,Mex
1346,23,23,1,1,0,0,1,1 (1ct 0st),0.043,2009,2014,LL Tsotsobe ,SA
1347,5,5,1,1,0,0,1,1 (1ct 0st),0.2,2019,2019,JJ Tucker ,BMUDA
1348,1,1,1,1,0,0,1,1 (1ct 0st),1.0,2009,2009,S Tyagi ,INDIA
1349,3,3,1,1,0,0,1,1 (1ct 0st),0.33299999999999996,2019,2019,A Uniyal ,Chile
1350,6,6,1,1,0,0,1,1 (1ct 0st),0.166,2019,2019,Usama Master ,MWI
1351,5,5,1,1,0,0,1,1 (1ct 0st),0.2,2019,2019,Usman Ali ,Saudi
1352,7,7,1,1,0,0,1,1 (1ct 0st),0.142,2010,2013,Usman Limbada ,CAN
1353,16,16,1,1,0,0,1,1 (1ct 0st),0.062,2013,2019,Usman Shinwari ,PAK
1354,6,6,1,1,0,0,1,1 (1ct 0st),0.166,2019,2019,Usman Waheed ,KUW
1355,10,10,1,1,0,0,1,1 (1ct 0st),0.1,2015,2019,JDF Vandersay ,SL
1356,2,2,1,1,0,0,1,1 (1ct 0st),0.5,2015,2015,MB van Schelven ,NL
1357,4,4,1,1,0,0,1,1 (1ct 0st),0.25,2019,2019,TCW Veillard ,GUE
1358,9,9,1,1,0,0,1,1 (1ct 0st),0.111,2019,2019,S Vijayakumar ,SGP
1359,2,2,1,1,0,0,1,1 (1ct 0st),0.5,2019,2019,Vimal Kumar ,PHI
1360,9,9,1,1,0,0,1,1 (1ct 0st),0.111,2010,2013,R Vinay Kumar ,INDIA
1361,9,9,1,1,0,0,1,1 (1ct 0st),0.111,2006,2007,L Vincent ,NZ
1362,10,10,1,1,0,0,1,1 (1ct 0st),0.1,2019,2019,W Viraliliu ,VAN
1363,1,1,1,1,0,0,1,1 (1ct 0st),1.0,2019,2019,Vishal Ahir ,PNM
1364,3,3,1,1,0,0,1,1 (1ct 0st),0.33299999999999996,2014,2016,KDK Vithanage ,SL
1365,4,4,1,1,0,0,1,1 (1ct 0st),0.25,2019,2019,Waqar Khan ,Peru
1366,2,2,1,1,0,0,1,1 (1ct 0st),0.5,2019,2019,Waqas Ali ,Belg
1367,2,2,1,1,0,0,1,1 (1ct 0st),0.5,2019,2019,Washeem Abbas ,MALTA
1368,2,2,1,1,0,0,1,1 (1ct 0st),0.5,2016,2016,VS Wategaonkar ,OMAN
1369,5,5,1,1,0,0,1,1 (1ct 0st),0.2,2009,2009,RM West ,IRE
1370,5,5,1,1,0,0,1,1 (1ct 0st),0.2,2019,2019,AA Westphal ,Mex
1371,5,5,1,1,0,0,1,1 (1ct 0st),0.2,2016,2017,BTJ Wheal ,SCOT
1372,6,6,1,1,0,0,1,1 (1ct 0st),0.166,2017,2018,BM Wheeler ,NZ
1373,5,5,1,1,0,0,1,1 (1ct 0st),0.2,2019,2019,S Wickramasekara ,CZK-R
1374,2,2,1,1,0,0,1,1 (1ct 0st),0.5,2019,2019,SA Wijeyeratne ,CAN
1375,2,2,1,1,0,0,1,1 (1ct 0st),0.5,2018,2018,JD Wildermuth ,AUS
1376,8,8,1,1,0,0,1,1 (1ct 0st),0.125,2011,2015,CR Woakes ,ENG
1377,3,3,1,1,0,0,1,1 (1ct 0st),0.33299999999999996,2010,2011,LJ Woodcock ,NZ
1378,2,2,1,1,0,0,1,1 (1ct 0st),0.5,2015,2015,GH Worker ,NZ
1379,8,8,1,1,0,0,1,1 (1ct 0st),0.125,2019,2019,AS Wright ,GUE
1380,3,2,1,1,0,0,1,1 (1ct 0st),0.5,2007,2009,CM Wright ,SCOT
1381,6,6,1,1,0,0,1,1 (1ct 0st),0.166,2019,2019,HN Ya France ,NAM
1382,1,1,1,1,0,0,1,1 (1ct 0st),1.0,2019,2019,Yasar Idrees ,KUW
1383,13,13,1,1,0,0,1,1 (1ct 0st),0.076,2007,2012,Yasir Arafat ,PAK
1384,3,3,1,1,0,0,1,1 (1ct 0st),0.33299999999999996,2015,2016,Zaheer Maqsood ,UAE
1385,3,3,1,1,0,0,1,1 (1ct 0st),0.33299999999999996,2012,2012,Zahid Hussain ,CAN
1386,2,2,1,1,0,0,1,1 (1ct 0st),0.5,2019,2019,Zameer Khan ,DEN
1387,27,26,1,1,0,0,1,1 (1ct 0st),0.038,2016,2019,A Zampa ,AUS
1388,3,3,1,1,0,0,1,1 (1ct 0st),0.33299999999999996,2019,2019,C Zavoiu ,ROM
1389,4,4,1,1,0,0,1,1 (1ct 0st),0.25,2019,2019,Zawar Farid ,UAE
1390,1,1,1,1,0,0,1,1 (1ct 0st),1.0,2019,2019,Zeeshan Abbas ,BAH
1391,4,4,1,1,0,0,1,1 (1ct 0st),0.25,2019,2019,Zubaidi Zulkifle ,MAL
1392,7,7,1,1,0,0,1,1 (1ct 0st),0.142,2013,2014,Zulfiqar Babar ,PAK
1393,3,3,1,0,1,0,0,1 (0ct 1st),0.33299999999999996,2007,2010,Zulqarnain Haider ,PAK
1394,5,5,1,1,0,0,1,1 (1ct 0st),0.2,2019,2019,Zulqarnain Haider ,ESP
1395,4,4,0,0,0,0,0,0,0.0,2019,2019,Aamer Ikram ,PORT
1396,2,2,0,0,0,0,0,0,0.0,2015,2018,Aamer Yamin ,PAK
1397,8,8,0,0,0,0,0,0,0.0,2019,2019,Aaron Jones ,USA
1398,1,1,0,0,0,0,0,0,0.0,2019,2019,Z Abbasi ,Botsw
1399,2,2,0,0,0,0,0,0,0.0,2019,2019,Abbas Saad ,Saudi
1400,2,2,0,0,0,0,0,0,0.0,2009,2009,YA Abdulla ,SA
1401,1,1,0,0,0,0,0,0,0.0,2019,2019,Abdullah Mahmood ,DEN
1402,2,2,0,0,0,0,0,0,0.0,2019,2019,Abdullah Sheikh ,NOR
1403,1,1,0,0,0,0,0,0,0.0,2019,2019,Abdul Rashid ,Belg
1404,1,1,0,0,0,0,0,0,0.0,2008,2008,Abdur Rauf ,PAK
1405,3,3,0,0,0,0,0,0,0.0,2019,2019,M Aboagye ,Ghana
1406,1,1,0,0,0,0,0,0,0.0,2019,2019,RA Abolarin ,NGA
1407,5,5,0,0,0,0,0,0,0.0,2012,2018,Abul Hasan ,BDESH
1408,3,3,0,0,0,0,0,0,0.0,2019,2019,AG Achar ,SGP
1409,1,1,0,0,0,0,0,0,0.0,2019,2019,F Achelam ,UGA
1410,4,4,0,0,0,0,0,0,0.0,2019,2019,Adil Hanif ,BAH
1411,1,1,0,0,0,0,0,0,0.0,2017,2017,Adnan Mufti ,UAE
1412,1,1,0,0,0,0,0,0,0.0,2019,2019,N Advani ,GIBR
1413,1,1,0,0,0,0,0,0,0.0,2019,2019,Aftab Ahmed ,DEN
1414,4,3,0,0,0,0,0,0,0.0,2006,2007,AB Agarkar ,INDIA
1415,3,3,0,0,0,0,0,0,0.0,2019,2019,A Ahmadhel ,
1416,2,2,0,0,0,0,0,0,0.0,2015,2015,RI Ahmed ,NL
1417,9,9,0,0,0,0,0,0,0.0,2019,2019,Ahmed Wardak ,GER
1418,6,6,0,0,0,0,0,0,0.0,2019,2019,Ahsan Abbasi ,HKG
1419,3,3,0,0,0,0,0,0,0.0,2019,2019,Ainool Hafizs ,MAL
1420,5,5,0,0,0,0,0,0,0.0,2011,2012,Aizaz Cheema ,PAK
1421,6,6,0,0,0,0,0,0,0.0,2019,2019,D Ajekun ,NGA
1422,2,2,0,0,0,0,0,0,0.0,2019,2019,C Akyuz ,TKY
1423,1,1,0,0,0,0,0,0,0.0,2019,2019,Ali Ivan ,Mald
1424,4,4,0,0,0,0,0,0,0.0,2019,2019,Ali Naqi ,PORT
1425,2,2,0,0,0,0,0,0,0.0,2019,2019,J Allen ,
1426,4,4,0,0,0,0,0,0,0.0,2019,2019,HS Alta ,TKY
1427,10,10,0,0,0,0,0,0,0.0,2019,2019,Ameel Mauroof ,Mald
1428,4,4,0,0,0,0,0,0,0.0,2019,2019,Ameer Saiyed ,Botsw
1429,4,4,0,0,0,0,0,0,0.0,2019,2019,Aminul Islam ,BDESH
1430,4,4,0,0,0,0,0,0,0.0,2018,2019,Amir Hayat ,UAE
1431,31,31,0,0,0,0,0,0,0.0,2013,2017,Amir Hamza ,AFG
1432,4,4,0,0,0,0,0,0,0.0,2019,2019,Ammad Uddin ,BAH
1433,1,1,0,0,0,0,0,0,0.0,2014,2014,Anas Khan ,HKG
1434,4,2,0,0,0,0,0,0,0.0,2015,2015,J Anderson ,IRE
1435,4,4,0,0,0,0,0,0,0.0,2019,2019,DK Anefie ,Ghana
1436,1,1,0,0,0,0,0,0,0.0,2019,2019,A Anemogiannis ,
1437,3,3,0,0,0,0,0,0,0.0,2019,2019,B Angeltti ,Arg
1438,4,4,0,0,0,0,0,0,0.0,2019,2019,DNA Ankrah ,Ghana
1439,11,10,0,0,0,0,0,0,0.0,2015,2016,M Ansari ,OMAN
1440,4,4,0,0,0,0,0,0,0.0,2019,2019,Ansar Iqbal ,NOR
1441,3,3,0,0,0,0,0,0,0.0,2018,2018,MA Aponso ,SL
1442,2,2,0,0,0,0,0,0,0.0,2019,2019,Apon Mustafizur ,Serb
1443,4,4,0,0,0,0,0,0,0.0,2019,2019,S Appu ,MALTA
1444,1,1,0,0,0,0,0,0,0.0,2015,2015,S Aravind ,INDIA
1445,1,1,0,0,0,0,0,0,0.0,2019,2019,JC Archer ,ENG
1446,3,3,0,0,0,0,0,0,0.0,2019,2019,Z Arinaitwe ,UGA
1447,1,1,0,0,0,0,0,0,0.0,2006,2006,RP Arnold ,SL
1448,4,4,0,0,0,0,0,0,0.0,2019,2019,B Arora ,MALTA
1449,2,2,0,0,0,0,0,0,0.0,2019,2019,Arsalan Arif ,Aut
1450,1,1,0,0,0,0,0,0,0.0,2010,2010,Arsalan Qadir ,CAN
1451,6,6,0,0,0,0,0,0,0.0,2019,2019,Arshad Hayat ,CZK-R
1452,3,3,0,0,0,0,0,0,0.0,2019,2019,Arslan Ahmed ,PORT
1453,3,3,0,0,0,0,0,0,0.0,2019,2019,Arslan Ahmed ,
1454,2,2,0,0,0,0,0,0,0.0,2013,2013,Asad Ali ,PAK
1455,3,3,0,0,0,0,0,0,0.0,2019,2019,A Aspiotis ,
1456,2,2,0,0,0,0,0,0,0.0,2006,2006,MS Atapattu ,SL
1457,3,3,0,0,0,0,0,0,0.0,2019,2019,S Ateak ,Ghana
1458,1,1,0,0,0,0,0,0,0.0,2016,2016,Atif Ali Khan ,UAE
1459,9,9,0,0,0,0,0,0,0.0,2019,2019,Atif Mehmood ,ESP
1460,4,4,0,0,0,0,0,0,0.0,2019,2019,R Avery ,
1461,5,5,0,0,0,0,0,0,0.0,2012,2014,Awais Zia ,PAK
1462,2,2,0,0,0,0,0,0,0.0,2012,2012,P Awana ,INDIA
1463,3,3,0,0,0,0,0,0,0.0,2019,2019,Aziz Mohammad ,Belg
1464,2,2,0,0,0,0,0,0,0.0,2019,2019,Azyan Farhath ,Mald
1465,1,1,0,0,0,0,0,0,0.0,2011,2011,S Badrinath ,INDIA
1466,3,3,0,0,0,0,0,0,0.0,2008,2009,LS Baker ,WI
1467,4,4,0,0,0,0,0,0,0.0,2019,2019,R Bakum ,Ghana
1468,5,5,0,0,0,0,0,0,0.0,2012,2012,L Balaji ,INDIA
1469,1,1,0,0,0,0,0,0,0.0,2016,2016,KMC Bandara ,SL
1470,3,3,0,0,0,0,0,0,0.0,2019,2019,HH Banner ,Blz
1471,4,4,0,0,0,0,0,0,0.0,2019,2019,TC Barker ,LUX
1472,1,1,0,0,0,0,0,0,0.0,2011,2011,MC Bascombe ,WI
1473,4,4,0,0,0,0,0,0,0.0,2019,2019,Bashir Shah ,DEN
1474,2,2,0,0,0,0,0,0,0.0,2010,2010,TC Bastiampillai ,CAN
1475,3,3,0,0,0,0,0,0,0.0,2012,2012,MD Bates ,NZ
1476,1,1,0,0,0,0,0,0,0.0,2009,2009,GJ Batty ,ENG
1477,1,1,0,0,0,0,0,0,0.0,2017,2017,D Bau ,PNG
1478,3,3,0,0,0,0,0,0,0.0,2008,2012,CS Baugh ,WI
1479,1,1,0,0,0,0,0,0,0.0,2009,2009,DE Bernard ,WI
1480,6,6,0,0,0,0,0,0,0.0,2013,2014,TL Best ,WI
1481,2,2,0,0,0,0,0,0,0.0,2019,2019,P Bharat Patel ,PNM
1482,6,6,0,0,0,0,0,0,0.0,2019,2019,S Bhari ,NEPAL
1483,5,5,0,0,0,0,0,0,0.0,2019,2019,P Bhart ,NOR
1484,1,1,0,0,0,0,0,0,0.0,2014,2014,A Bhattarai ,NEPAL
1485,7,7,0,0,0,0,0,0,0.0,2008,2010,U Bhatti ,CAN
1486,1,1,0,0,0,0,0,0,0.0,2019,2019,Bilal Ahmed ,Serb
1487,2,2,0,0,0,0,0,0,0.0,2010,2010,IS Billcliff ,CAN
1488,3,3,0,0,0,0,0,0,0.0,2015,2016,STR Binny ,INDIA
1489,4,4,0,0,0,0,0,0,0.0,2019,2019,K Birkenstock ,NAM
1490,3,3,0,0,0,0,0,0,0.0,2019,2019,KK Bishnoi ,
1491,3,3,0,0,0,0,0,0,0.0,2019,2019,CC Blake ,VAN
1492,1,1,0,0,0,0,0,0,0.0,2010,2010,AM Blignaut ,ZIM
1493,1,1,0,0,0,0,0,0,0.0,2007,2007,GH Bodi ,SA
1494,1,1,0,0,0,0,0,0,0.0,2005,2005,N Boje ,SA
1495,2,2,0,0,0,0,0,0,0.0,2011,2012,NE Bonner ,WI
1496,7,7,0,0,0,0,0,0,0.0,2014,2016,CJ Boyce ,AUS
1497,3,3,0,0,0,0,0,0,0.0,2019,2019,TS Braat ,NL
1498,5,5,0,0,0,0,0,0,0.0,2019,2019,DL Brangman ,BMUDA
1499,2,1,0,0,0,0,0,0,0.0,2007,2007,DR Brown ,SCOT
1500,4,4,0,0,0,0,0,0,0.0,2019,2019,P Buccimazza ,PORT
1501,4,4,0,0,0,0,0,0,0.0,2014,2014,NB Budayair ,NEPAL
1502,2,1,0,0,0,0,0,0,0.0,2019,2019,A Bulow ,DEN
1503,1,1,0,0,0,0,0,0,0.0,2013,2013,CG Burnett ,SCOT
1504,2,2,0,0,0,0,0,0,0.0,2019,2019,S Byrne ,MALTA
1505,4,4,0,0,0,0,0,0,0.0,2019,2019,G Caisley ,
1506,9,9,0,0,0,0,0,0,0.0,2019,2019,HL Carlyon ,JER
1507,4,4,0,0,0,0,0,0,0.0,2019,2019,A Carthew ,Chile
1508,2,2,0,0,0,0,0,0,0.0,2019,2019,T Caruana ,GIBR
1509,3,3,0,0,0,0,0,0,0.0,2019,2019,D Cato ,Caym
1510,3,3,0,0,0,0,0,0,0.0,2008,2008,JJ Celestine ,BMUDA
1511,10,10,0,0,0,0,0,0,0.0,2018,2019,DL Chahar ,INDIA
1512,1,1,0,0,0,0,0,0,0.0,2019,2019,RD Chahar ,INDIA
1513,3,2,0,0,0,0,0,0,0.0,2019,2019,Charanjeet Singh ,ITA
1514,2,2,0,0,0,0,0,0,0.0,2019,2019,G Chaturvedi ,MALTA
1515,2,2,0,0,0,0,0,0,0.0,2019,2019,M Chauhan ,Fin
1516,7,7,0,0,0,0,0,0,0.0,2019,2019,VB Chikkannaiah ,GER
1517,7,7,0,0,0,0,0,0,0.0,2018,2019,Chirag Suri ,UAE
1518,1,1,0,0,0,0,0,0,0.0,2019,2019,S Chophel ,BHU
1519,2,2,0,0,0,0,0,0,0.0,2011,2011,DO Christian ,WI
1520,1,1,0,0,0,0,0,0,0.0,2019,2019,I Civric ,Serb
1521,2,2,0,0,0,0,0,0,0.0,2018,2019,GL Cloete ,SA
1522,1,1,0,0,0,0,0,0,0.0,2013,2013,FRJ Coleman ,SCOT
1523,5,5,0,0,0,0,0,0,0.0,2019,2019,NG Collins ,Fin
1524,4,4,0,0,0,0,0,0,0.0,2019,2019,MNR Cooray ,Mald
1525,2,2,0,0,0,0,0,0,0.0,2019,2019,M Cope ,LUX
1526,4,4,0,0,0,0,0,0,0.0,2019,2019,SJ Cotter ,Samoa
1527,2,2,0,0,0,0,0,0,0.0,2017,2017,MS Crane ,ENG
1528,5,5,0,0,0,0,0,0,0.0,2019,2019,SM Curran ,ENG
1529,1,1,0,0,0,0,0,0,0.0,2013,2013,D Daesrath ,CAN
1530,2,2,0,0,0,0,0,0,0.0,2019,2019,H Dajc ,Serb
1531,3,3,0,0,0,0,0,0,0.0,2019,2019,S Dalton ,CZK-R
1532,3,3,0,0,0,0,0,0,0.0,2019,2019,I Danladi ,NGA
1533,9,9,0,0,0,0,0,0,0.0,2012,2013,H Davids ,SA
1534,2,2,0,0,0,0,0,0,0.0,2019,2019,S Davizi ,CZK-R
1535,2,2,0,0,0,0,0,0,0.0,2010,2010,Dawlat Ahmadzai ,AFG
1536,8,8,0,0,0,0,0,0,0.0,2019,2019,DC Delany ,IRE
1537,2,2,0,0,0,0,0,0,0.0,2019,2019,D de la Puente ,Peru
1538,1,1,0,0,0,0,0,0,0.0,2012,2012,PA Desai ,CAN
1539,3,3,0,0,0,0,0,0,0.0,2017,2017,ST de Silva ,SL
1540,1,1,0,0,0,0,0,0,0.0,2009,2009,BJ Diamanti ,NZ
1541,3,3,0,0,0,0,0,0,0.0,2019,2019,V Dikov ,
1542,2,2,0,0,0,0,0,0,0.0,2008,2008,LHD Dilhara ,SL
1543,4,3,0,0,0,0,0,0,0.0,2019,2019,SDJJ Dima ,Moz
1544,3,3,0,0,0,0,0,0,0.0,2019,2019,N Dipakkumar Patel ,PNM
1545,1,1,0,0,0,0,0,0,0.0,2006,2006,HH Dippenaar ,SA
1546,3,3,0,0,0,0,0,0,0.0,2019,2019,M Dixit ,LUX
1547,2,2,0,0,0,0,0,0,0.0,2019,2019,A Djorovic ,Serb
1548,11,11,0,0,0,0,0,0,0.0,2012,2013,XJ Doherty ,AUS
1549,1,1,0,0,0,0,0,0,0.0,2019,2019,JN Dorji ,BHU
1550,2,2,0,0,0,0,0,0,0.0,2019,2019,K Dorji ,BHU
1551,1,1,0,0,0,0,0,0,0.0,2019,2019,RM Dorji ,BHU
1552,2,2,0,0,0,0,0,0,0.0,2019,2019,U Dorji ,BHU
1553,2,2,0,0,0,0,0,0,0.0,2009,2010,TM Dowlin ,WI
1554,1,1,0,0,0,0,0,0,0.0,2011,2011,R Dravid ,INDIA
1555,1,1,0,0,0,0,0,0,0.0,2019,2019,BM Duckett ,ENG
1556,2,2,0,0,0,0,0,0,0.0,2019,2019,B Dugic ,Serb
1557,4,4,0,0,0,0,0,0,0.0,2019,2019,J Dunn ,VAN
1558,1,1,0,0,0,0,0,0,0.0,2010,2010,PS Eaglestone ,IRE
1559,5,5,0,0,0,0,0,0,0.0,2019,2019,KR Ebanks ,Caym
1560,5,5,0,0,0,0,0,0,0.0,2014,2017,Ehsan Nawaz ,HKG
1561,5,5,0,0,0,0,0,0,0.0,2012,2013,AM Ellis ,NZ
1562,2,2,0,0,0,0,0,0,0.0,2019,2019,C Emmott ,Chile
1563,4,4,0,0,0,0,0,0,0.0,2018,2018,RR Emrit ,WI
1564,6,6,0,0,0,0,0,0,0.0,2014,2015,Faizan Asif ,UAE
1565,4,4,0,0,0,0,0,0,0.0,2019,2019,Fakhrul Mohon ,PORT
1566,2,2,0,0,0,0,0,0,0.0,2013,2013,Fawad Ahmed ,AUS
1567,1,1,0,0,0,0,0,0,0.0,2019,2019,Fazal Niazai ,AFG
1568,5,5,0,0,0,0,0,0,0.0,2019,2019,H Fennell ,Arg
1569,2,2,0,0,0,0,0,0,0.0,2015,2015,B Fernando ,SL
1570,3,3,0,0,0,0,0,0,0.0,2019,2019,BOP Fernando ,SL
1571,1,1,0,0,0,0,0,0,0.0,2017,2017,MVT Fernando ,SL
1572,3,3,0,0,0,0,0,0,0.0,2019,2019,Fiaz Ahmad ,KUW
1573,2,2,0,0,0,0,0,0,0.0,2019,2019,Fida Hussain ,ITA
1574,4,4,0,0,0,0,0,0,0.0,2012,2012,R Flannigan ,SCOT
1575,4,4,0,0,0,0,0,0,0.0,2019,2019,P Florin ,ROM
1576,3,3,0,0,0,0,0,0,0.0,2019,2019,KK Flowers ,Blz
1577,2,2,0,0,0,0,0,0,0.0,2019,2019,C Floyd ,NL
1578,2,2,0,0,0,0,0,0,0.0,2019,2019,BC Fortuin ,SA
1579,3,3,0,0,0,0,0,0,0.0,2019,2019,AR Gandhi ,KENYA
1580,1,1,0,0,0,0,0,0,0.0,2006,2006,D Ganga ,WI
1581,4,4,0,0,0,0,0,0,0.0,2019,2019,MD Garratt ,GIBR
1582,1,1,0,0,0,0,0,0,0.0,2019,2019,Garret Banner ,Blz
1583,9,9,0,0,0,0,0,0,0.0,2014,2015,SP Gauchan ,NEPAL
1584,1,1,0,0,0,0,0,0,0.0,2019,2019,A Gavde ,Caym
1585,2,2,0,0,0,0,0,0,0.0,2019,2019,R Gaznavi ,SGP
1586,1,1,0,0,0,0,0,0,0.0,2009,2009,B Geeves ,AUS
1587,2,2,0,0,0,0,0,0,0.0,2019,2019,L Gharasim ,ROM
1588,1,1,0,0,0,0,0,0,0.0,2005,2005,JN Gillespie ,AUS
1589,1,1,0,0,0,0,0,0,0.0,2019,2019,O Goker ,TKY
1590,7,6,0,0,0,0,0,0,0.0,2019,2019,GF Gomes ,Moz
1591,1,1,0,0,0,0,0,0,0.0,2019,2019,M Goonetilleke ,MALTA
1592,2,2,0,0,0,0,0,0,0.0,2005,2006,D Gough ,ENG
1593,3,3,0,0,0,0,0,0,0.0,2019,2019,S Goustis ,
1594,5,5,0,0,0,0,0,0,0.0,2019,2019,L Gregory ,ENG
1595,8,8,0,0,0,0,0,0,0.0,2012,2013,R Gunasekera ,CAN
1596,2,2,0,0,0,0,0,0,0.0,2014,2014,HF Gurney ,ENG
1597,2,2,0,0,0,0,0,0,0.0,2006,2006,AJ Hall ,SA
1598,2,2,0,0,0,0,0,0,0.0,2019,2019,PSP Handscomb ,AUS
1599,3,3,0,0,0,0,0,0,0.0,2019,2019,Hardev Singh ,Chile
1600,10,10,0,0,0,0,0,0,0.0,2019,2019,Haroon Arshad ,HKG
1601,4,4,0,0,0,0,0,0,0.0,2019,2019,Haroon Mughal ,MALTA
1602,4,4,0,0,0,0,0,0,0.0,2019,2019,LHB Harrington-Myers ,Caym
1603,3,3,0,0,0,0,0,0,0.0,2010,2010,RJ Harris ,AUS
1604,3,3,0,0,0,0,0,0,0.0,2007,2009,SM Harwood ,AUS
1605,2,2,0,0,0,0,0,0,0.0,2019,2019,Hasheem Shahzad ,MALTA
1606,1,1,0,0,0,0,0,0,0.0,2013,2013,Hashmatullah Shahidi ,AFG
1607,8,8,0,0,0,0,0,0,0.0,2019,2019,Hassan Rasheed ,Mald
1608,1,1,0,0,0,0,0,0,0.0,2019,2019,RJ Hatchman ,GIBR
1609,4,4,0,0,0,0,0,0,0.0,2019,2019,Hayatullah Niazi ,NOR
1610,4,4,0,0,0,0,0,0,0.0,2019,2019,H Helva ,TKY
1611,2,2,0,0,0,0,0,0,0.0,2008,2008,DL Hemp ,BMUDA
1612,1,1,0,0,0,0,0,0,0.0,2006,2006,T Henderson ,SA
1613,8,8,0,0,0,0,0,0,0.0,2019,2019,PD Hennessy ,ESP
1614,17,17,0,0,0,0,0,0,0.0,2011,2016,HMRKB Herath ,SL
1615,7,7,0,0,0,0,0,0,0.0,2007,2012,BW Hilfenhaus ,AUS
1616,4,4,0,0,0,0,0,0,0.0,2019,2019,J Hill ,PHI
1617,5,5,0,0,0,0,0,0,0.0,2016,2019,H Hiri ,PNG
1618,4,4,0,0,0,0,0,0,0.0,2019,2019,J Hirschi ,MALTA
1619,1,1,0,0,0,0,0,0,0.0,2008,2008,PA Hitchcock ,NZ
1620,1,1,0,0,0,0,0,0,0.0,2008,2008,KC Hodsoll ,BMUDA
1621,3,3,0,0,0,0,0,0,0.0,2019,2019,S Hongsi ,THAI
1622,1,1,0,0,0,0,0,0,0.0,2014,2014,PJ Hughes ,AUS
1623,2,2,0,0,0,0,0,0,0.0,2019,2019,EH Hutchinson ,USA
1624,1,1,0,0,0,0,0,0,0.0,2019,2019,Ibrahim Khan ,Saudi
1625,2,2,0,0,0,0,0,0,0.0,2007,2009,Iftikhar Anjum ,PAK
1626,3,3,0,0,0,0,0,0,0.0,2019,2019,Ijaz Hussain ,ROM
1627,2,2,0,0,0,0,0,0,0.0,2019,2019,Imam-ul-Haq ,PAK
1628,4,4,0,0,0,0,0,0,0.0,2019,2019,Imran Ali Butt ,BAH
1629,3,3,0,0,0,0,0,0,0.0,2019,2019,Imran Bulbulia ,PNM
1630,4,4,0,0,0,0,0,0,0.0,2019,2019,Imran Khan ,PORT
1631,3,3,0,0,0,0,0,0,0.0,2019,2019,RK Inampud ,Mex
1632,1,1,0,0,0,0,0,0,0.0,2006,2006,Inzamam-ul-Haq ,PAK
1633,1,1,0,0,0,0,0,0,0.0,2006,2006,AJ Ireland ,ZIM
1634,4,4,0,0,0,0,0,0,0.0,2019,2019,Irfan Bhima ,MWI
1635,4,4,0,0,0,0,0,0,0.0,2019,2019,Irfan Mir ,Chile
1636,3,3,0,0,0,0,0,0,0.0,2019,2019,E Isaneez ,UGA
1637,3,3,0,0,0,0,0,0,0.0,2019,2019,B Ivanov ,
1638,2,2,0,0,0,0,0,0,0.0,2019,2019,D Jakiel ,ZIM
1639,2,2,0,0,0,0,0,0,0.0,2019,2019,NA Janes ,THAI
1640,2,2,0,0,0,0,0,0,0.0,2019,2019,T Jamtsho ,BHU
1641,3,3,0,0,0,0,0,0,0.0,2012,2017,Javed Ahmadi ,AFG
1642,2,2,0,0,0,0,0,0,0.0,2019,2019,Javed Maroofkhail ,NOR
1643,5,5,0,0,0,0,0,0,0.0,2009,2010,CU Jayasinghe ,SL
1644,2,2,0,0,0,0,0,0,0.0,2019,2019,P Jayeshbhai Patel ,PNM
1645,3,3,0,0,0,0,0,0,0.0,2019,2019,Jay Odedra ,OMAN
1646,1,1,0,0,0,0,0,0,0.0,2007,2007,JS Jesani ,KENYA
1647,4,4,0,0,0,0,0,0,0.0,2019,2019,HJ Jordaan ,THAI
1648,1,1,0,0,0,0,0,0,0.0,2019,2019,GJ Joseph ,Blz
1649,4,4,0,0,0,0,0,0,0.0,2019,2019,K Joshi ,Aut
1650,1,1,0,0,0,0,0,0,0.0,2015,2015,Jubair Hossain ,BDESH
1651,9,9,0,0,0,0,0,0,0.0,2011,2014,Junaid Khan ,PAK
1652,2,2,0,0,0,0,0,0,0.0,2008,2008,S Jyoti ,CAN
1653,6,6,0,0,0,0,0,0,0.0,2017,2019,Kaleemullah ,OMAN
1654,3,3,0,0,0,0,0,0,0.0,2019,2019,G Kaltongga ,VAN
1655,7,7,0,0,0,0,0,0,0.0,2010,2011,S Randiv ,SL
1656,1,1,0,0,0,0,0,0,0.0,2014,2014,TP Kamungozi ,ZIM
1657,4,4,0,0,0,0,0,0,0.0,2019,2019,S Kansoy ,TKY
1658,2,2,0,0,0,0,0,0,0.0,2015,2015,A Karn ,NEPAL
1659,1,1,0,0,0,0,0,0,0.0,2007,2007,M Kartik ,INDIA
1660,4,4,0,0,0,0,0,0,0.0,2008,2008,E Katchay ,CAN
1661,3,3,0,0,0,0,0,0,0.0,2018,2019,S Kaul ,INDIA
1662,3,3,0,0,0,0,0,0,0.0,2019,2019,HB Kayondo ,UGA
1663,4,4,0,0,0,0,0,0,0.0,2019,2019,D Kegasitswe ,Botsw
1664,3,3,0,0,0,0,0,0,0.0,2008,2008,SKW Kelly ,BMUDA
1665,6,6,0,0,0,0,0,0,0.0,2019,2019,P Kerai ,KENYA
1666,1,1,0,0,0,0,0,0,0.0,2009,2009,A Khan ,ENG
1667,3,3,0,0,0,0,0,0,0.0,2019,2019,B Khumalo ,Botsw
1668,3,3,0,0,0,0,0,0,0.0,2016,2016,Khurram Manzoor ,PAK
1669,1,1,0,0,0,0,0,0,0.0,2019,2019,Khushdil Shah ,PAK
1670,4,4,0,0,0,0,0,0,0.0,2019,2019,JH Kiani ,PHI
1671,1,1,0,0,0,0,0,0,0.0,2010,2010,GE Kidd ,IRE
1672,4,4,0,0,0,0,0,0,0.0,2016,2019,VJ Kingma ,NL
1673,1,1,0,0,0,0,0,0,0.0,2007,2007,RJ Kirtley ,ENG
1674,4,4,0,0,0,0,0,0,0.0,2019,2019,S Kizilkaya ,TKY
1675,2,2,0,0,0,0,0,0,0.0,2019,2019,MF Koc ,TKY
1676,4,4,0,0,0,0,0,0,0.0,2019,2019,AC Kose ,TKY
1677,4,4,0,0,0,0,0,0,0.0,2019,2019,A Krishna ,SGP
1678,1,1,0,0,0,0,0,0,0.0,2006,2006,GJP Kruger ,SA
1679,2,2,0,0,0,0,0,0,0.0,2016,2016,DS Kulkarni ,INDIA
1680,3,3,0,0,0,0,0,0,0.0,2019,2019,CBRLS Kumara ,SL
1681,3,3,0,0,0,0,0,0,0.0,2019,2019,Kushal Malla ,NEPAL
1682,5,5,0,0,0,0,0,0,0.0,2010,2010,GA Lamb ,ZIM
1683,1,1,0,0,0,0,0,0,0.0,2019,2019,T Langa ,VAN
1684,2,2,0,0,0,0,0,0,0.0,2015,2015,E Leie ,SA
1685,2,2,0,0,0,0,0,0,0.0,2008,2008,RDM Leverock ,BMUDA
1686,1,1,0,0,0,0,0,0,0.0,2019,2019,I Lisboa ,Chile
1687,2,2,0,0,0,0,0,0,0.0,2017,2017,LS Livingstone ,ENG
1688,2,2,0,0,0,0,0,0,0.0,2019,2019,CA Liyanage ,Mald
1689,1,1,0,0,0,0,0,0,0.0,2019,2019,K Loday ,BHU
1690,2,2,0,0,0,0,0,0,0.0,2008,2009,J Louw ,SA
1691,1,1,0,0,0,0,0,0,0.0,2019,2019,L Louwrens ,NAM
1692,2,2,0,0,0,0,0,0,0.0,2019,2019,Lucky Ali ,DEN
1693,2,2,0,0,0,0,0,0,0.0,2016,2018,NM Lyon ,AUS
1694,2,2,0,0,0,0,0,0,0.0,2010,2010,RT Lyons ,SCOT
1695,1,1,0,0,0,0,0,0,0.0,2018,2018,AM McCarthy ,WI
1696,11,10,0,0,0,0,0,0,0.0,2007,2010,NFI McCallum ,SCOT
1697,2,2,0,0,0,0,0,0,0.0,2019,2019,OC McCoy ,WI
1698,2,2,0,0,0,0,0,0,0.0,2010,2010,AJ McKay ,NZ
1699,6,6,0,0,0,0,0,0,0.0,2010,2013,CJ McKay ,AUS
1700,2,2,0,0,0,0,0,0,0.0,2006,2009,ND McKenzie ,SA
1701,2,2,0,0,0,0,0,0,0.0,2018,2018,DSK Madushanka ,SL
1702,2,2,0,0,0,0,0,0,0.0,2019,2019,LD Madushanka ,SL
1703,6,6,0,0,0,0,0,0,0.0,2014,2015,RP Magar ,NEPAL
1704,3,3,0,0,0,0,0,0,0.0,2019,2019,R Mahajan ,PHI
1705,3,3,0,0,0,0,0,0,0.0,2019,2019,C Mahoney ,Peru
1706,3,3,0,0,0,0,0,0,0.0,2019,2019,Mamoon Latif ,Belg
1707,3,3,0,0,0,0,0,0,0.0,2019,2019,G Manan ,ROM
1708,2,2,0,0,0,0,0,0,0.0,2019,2019,D Manani ,ROM
1709,1,1,0,0,0,0,0,0,0.0,2019,2019,M Markande ,INDIA
1710,2,2,0,0,0,0,0,0,0.0,2019,2019,D Marks ,MALTA
1711,3,3,0,0,0,0,0,0,0.0,2005,2008,JAH Marshall ,NZ
1712,3,3,0,0,0,0,0,0,0.0,2019,2019,JL Martel ,GUE
1713,1,1,0,0,0,0,0,0,0.0,2019,2019,B Masaba ,UGA
1714,3,3,0,0,0,0,0,0,0.0,2006,2008,MJ Mason ,NZ
1715,2,2,0,0,0,0,0,0,0.0,2019,2019,N Master ,Botsw
1716,7,6,0,0,0,0,0,0,0.0,2019,2019,ZE Matsinhe ,Moz
1717,4,4,0,0,0,0,0,0,0.0,2019,2019,V Mbazo ,Botsw
1718,3,2,0,0,0,0,0,0,0.0,2015,2015,GJ McCarter ,IRE
1719,6,6,0,0,0,0,0,0,0.0,2017,2018,BJ McCarthy ,IRE
1720,3,3,0,0,0,0,0,0,0.0,2019,2019,Z McLaughlin ,Caym
1721,2,2,0,0,0,0,0,0,0.0,2016,2016,A Mehmood ,HKG
1722,2,2,0,0,0,0,0,0,0.0,2008,2009,Mehrab Hossain jnr ,BDESH
1723,3,3,0,0,0,0,0,0,0.0,2019,2019,D Mejia ,CRC
1724,6,6,0,0,0,0,0,0,0.0,2019,2019,K Mendon ,CZK-R
1725,2,2,0,0,0,0,0,0,0.0,2019,2019,JH Mensah ,Ghana
1726,4,4,0,0,0,0,0,0,0.0,2019,2019,DP Michael ,Samoa
1727,1,1,0,0,0,0,0,0,0.0,2019,2019,Michael Nazir ,MALTA
1728,1,1,0,0,0,0,0,0,0.0,2019,2019,Mihusan Hamid ,Mald
1729,5,5,0,0,0,0,0,0,0.0,2019,2019,Mirza Ahsan ,Aut
1730,5,5,0,0,0,0,0,0,0.0,2019,2019,Mohamed Arief ,MAL
1731,2,2,0,0,0,0,0,0,0.0,2019,2019,Mohameed Taiwo ,NGA
1732,5,5,0,0,0,0,0,0,0.0,2019,2019,Mohammad Adnan ,Saudi
1733,6,6,0,0,0,0,0,0,0.0,2019,2019,Mohammad Ahsan ,KUW
1734,4,4,0,0,0,0,0,0,0.0,2019,2019,Mohammad Amin ,KUW
1735,4,4,0,0,0,0,0,0,0.0,2019,2019,Mohammad Hasnain ,PAK
1736,3,3,0,0,0,0,0,0,0.0,2008,2008,Mohammad Iqbal ,CAN
1737,11,11,0,0,0,0,0,0,0.0,2019,2019,Mohamed Mahfooz ,Mald
1738,1,1,0,0,0,0,0,0,0.0,2008,2008,Mohammad Qazi ,CAN
1739,1,1,0,0,0,0,0,0,0.0,2006,2006,Mohammad Rafique ,BDESH
1740,1,1,0,0,0,0,0,0,0.0,2016,2016,Mohammad Shahid ,BDESH
1741,8,8,0,0,0,0,0,0,0.0,2014,2019,Mohammed Shami ,INDIA
1742,1,1,0,0,0,0,0,0,0.0,2019,2019,MR Montfort ,CAN
1743,5,5,0,0,0,0,0,0,0.0,2015,2017,VV Morea ,PNG
1744,6,6,0,0,0,0,0,0,0.0,2019,2019,A Morris ,Caym
1745,3,3,0,0,0,0,0,0,0.0,2019,2019,JWN Moses ,Botsw
1746,4,4,0,0,0,0,0,0,0.0,2019,2019,Mohsin Hub ,Peru
1747,5,5,0,0,0,0,0,0,0.0,2019,2019,Muaviath Ganee ,Mald
1748,4,4,0,0,0,0,0,0,0.0,2019,2019,Muhammad Hamayun ,Saudi
1749,1,1,0,0,0,0,0,0,0.0,2019,2019,Muhammad Musa ,PAK
1750,2,2,0,0,0,0,0,0,0.0,2019,2019,Muhammad Rafique ,BAH
1751,1,1,0,0,0,0,0,0,0.0,2016,2016,Muhammed Shanil ,UAE
1752,4,4,0,0,0,0,0,0,0.0,2019,2019,Muhammad Wafiq ,MAL
1753,4,4,0,0,0,0,0,0,0.0,2019,2019,D Muhumuza ,UGA
1754,2,2,0,0,0,0,0,0,0.0,2019,2019,Mukhtiar Singh ,ESP
1755,1,1,0,0,0,0,0,0,0.0,2016,2016,Muktar Ali ,BDESH
1756,4,4,0,0,0,0,0,0,0.0,2019,2019,FF Mulivai ,Samoa
1757,4,4,0,0,0,0,0,0,0.0,2007,2008,T Mupariwa ,ZIM
1758,3,3,0,0,0,0,0,0,0.0,2019,2019,S Murari ,CRC
1759,1,1,0,0,0,0,0,0,0.0,2019,2019,Musa Shaheen ,DEN
1760,2,2,0,0,0,0,0,0,0.0,2008,2008,P Mustard ,ENG
1761,3,3,0,0,0,0,0,0,0.0,2011,2012,F Mutizwa ,ZIM
1762,3,3,0,0,0,0,0,0,0.0,2006,2007,Nadif Chowdhury ,BDESH
1763,2,2,0,0,0,0,0,0,0.0,2019,2019,S Nadigotla ,ROM
1764,1,1,0,0,0,0,0,0,0.0,2014,2014,Najeeb Amar ,HKG
1765,3,3,0,0,0,0,0,0,0.0,2019,2019,A Nanda ,LUX
1766,2,2,0,0,0,0,0,0,0.0,2019,2019,M Nandela ,Mex
1767,2,2,0,0,0,0,0,0,0.0,2017,2017,A Nao ,PNG
1768,1,1,0,0,0,0,0,0,0.0,2015,2015,Nasir Aziz ,UAE
1769,8,8,0,0,0,0,0,0,0.0,2019,2019,Nasrulla Rana ,HKG
1770,1,1,0,0,0,0,0,0,0.0,2015,2015,Nauman Anwar ,PAK
1771,1,1,0,0,0,0,0,0,0.0,2019,2019,NH Naureen ,ESP
1772,4,4,0,0,0,0,0,0,0.0,2019,2019,Naveen-ul-Haq ,AFG
1773,1,1,0,0,0,0,0,0,0.0,2019,2019,Nawaf Ahmed ,KUW
1774,7,7,0,0,0,0,0,0,0.0,2007,2008,Nazimuddin ,BDESH
1775,4,4,0,0,0,0,0,0,0.0,2009,2012,Nazmul Hossain ,BDESH
1776,1,1,0,0,0,0,0,0,0.0,2006,2006,Nazmus Sadat ,BDESH
1777,3,3,0,0,0,0,0,0,0.0,2019,2019,R Neale ,LUX
1778,2,2,0,0,0,0,0,0,0.0,2019,2019,S Nerandzic ,Serb
1779,1,1,0,0,0,0,0,0,0.0,2019,2019,R Ngarava ,ZIM
1780,7,7,0,0,0,0,0,0,0.0,2012,2013,JO Ngoche ,KENYA
1781,5,5,0,0,0,0,0,0,0.0,2016,2019,HM Nicholls ,NZ
1782,3,3,0,0,0,0,0,0,0.0,2019,2019,D Nikolov ,
1783,1,1,0,0,0,0,0,0,0.0,2019,2019,K Nima ,BHU
1784,1,1,0,0,0,0,0,0,0.0,2006,2006,ML Nkala ,ZIM
1785,4,4,0,0,0,0,0,0,0.0,2019,2019,F Nkhoma ,MWI
1786,2,2,0,0,0,0,0,0,0.0,2007,2008,AA Noffke ,AUS
1787,1,1,0,0,0,0,0,0,0.0,2019,2019,Noman Kamawi ,Belg
1788,1,1,0,0,0,0,0,0,0.0,2009,2009,MJ North ,AUS
1789,1,1,0,0,0,0,0,0,0.0,2019,2019,A Nortje ,SA
1790,3,3,0,0,0,0,0,0,0.0,2015,2015,L Nou ,PNG
1791,3,3,0,0,0,0,0,0,0.0,2019,2019,GM Ntambalika ,MWI
1792,2,2,0,0,0,0,0,0,0.0,2018,2018,J Nyumbu ,ZIM
1793,4,4,0,0,0,0,0,0,0.0,2009,2009,IE O'Brien ,NZ
1794,2,2,0,0,0,0,0,0,0.0,2010,2010,NV Ojha ,INDIA
1795,8,8,0,0,0,0,0,0,0.0,2007,2008,PJ Ongondo ,KENYA
1796,5,5,0,0,0,0,0,0,0.0,2007,2010,LN Onyango ,KENYA
1797,1,1,0,0,0,0,0,0,0.0,2019,2019,A Orfila ,GIBR
1798,3,3,0,0,0,0,0,0,0.0,2019,2019,Ovais Yousof ,NGA
1799,5,5,0,0,0,0,0,0,0.0,2019,2019,VS Padhaal ,Fin
1800,4,4,0,0,0,0,0,0,0.0,2019,2019,BA Pai ,GIBR
1801,2,2,0,0,0,0,0,0,0.0,2019,2019,RJG Palmer ,JER
1802,1,1,0,0,0,0,0,0,0.0,2007,2007,MS Panesar ,ENG
1803,1,1,0,0,0,0,0,0,0.0,2007,2007,BA Parchment ,WI
1804,2,2,0,0,0,0,0,0,0.0,2012,2012,MA Parker ,SCOT
1805,2,2,0,0,0,0,0,0,0.0,2019,2019,MW Parkinson ,ENG
1806,1,1,0,0,0,0,0,0,0.0,2017,2017,Parvez Rasool ,INDIA
1807,2,2,0,0,0,0,0,0,0.0,2019,2019,A Patel ,MWI
1808,2,2,0,0,0,0,0,0,0.0,2018,2018,AY Patel ,NZ
1809,2,2,0,0,0,0,0,0,0.0,2019,2019,M Patel ,PNM
1810,3,3,0,0,0,0,0,0,0.0,2019,2019,M Patel ,Chile
1811,3,3,0,0,0,0,0,0,0.0,2019,2019,MIA Patel ,MWI
1812,3,3,0,0,0,0,0,0,0.0,2011,2011,MM Patel ,INDIA
1813,7,7,0,0,0,0,0,0,0.0,2019,2019,TK Patel ,USA
1814,4,4,0,0,0,0,0,0,0.0,2019,2019,N Pathan ,THAI
1815,5,5,0,0,0,0,0,0,0.0,2016,2017,SS Pathirana ,SL
1816,8,8,0,0,0,0,0,0,0.0,2019,2019,WA Peatfield ,GUE
1817,3,3,0,0,0,0,0,0,0.0,2011,2011,MDK Perera ,SL
1818,2,2,0,0,0,0,0,0,0.0,2006,2006,PDRL Perera ,SL
1819,4,4,0,0,0,0,0,0,0.0,2019,2019,S Periyalwar ,ROM
1820,1,1,0,0,0,0,0,0,0.0,2018,2018,V Permaul ,WI
1821,16,16,0,0,0,0,0,0,0.0,2012,2018,AM Phangiso ,SA
1822,1,1,0,0,0,0,0,0,0.0,2019,2019,T Phaswana ,Botsw
1823,3,3,0,0,0,0,0,0,0.0,2019,2019,S Pillai ,CRC
1824,1,1,0,0,0,0,0,0,0.0,2007,2007,LA Pomersbach ,AUS
1825,3,3,0,0,0,0,0,0,0.0,2019,2019,VRCF Poubel ,
1826,4,4,0,0,0,0,0,0,0.0,2019,2019,H Pragji ,Botsw
1827,3,3,0,0,0,0,0,0,0.0,2019,2019,C Prasad ,CRC
1828,1,1,0,0,0,0,0,0,0.0,2011,2011,KTGD Prasad ,SL
1829,6,6,0,0,0,0,0,0,0.0,2017,2019,D Pretorius ,SA
1830,1,1,0,0,0,0,0,0,0.0,2005,2005,AG Prince ,SA
1831,3,3,0,0,0,0,0,0,0.0,2017,2017,SMA Priyanjan ,SL
1832,4,4,0,0,0,0,0,0,0.0,2019,2019,Qalandar Khan ,QAT
1833,3,3,0,0,0,0,0,0,0.0,2019,2019,Qasim Zia ,BAH
1834,3,3,0,0,0,0,0,0,0.0,2015,2015,Rafatullah Mohmand ,PAK
1835,2,2,0,0,0,0,0,0,0.0,2019,2019,Rahman Ademi ,Serb
1836,2,2,0,0,0,0,0,0,0.0,2016,2016,P Raho ,PNG
1837,2,2,0,0,0,0,0,0,0.0,2010,2010,EC Rainsford ,ZIM
1838,5,5,0,0,0,0,0,0,0.0,2019,2019,PBB Rajapaksa ,SL
1839,3,3,0,0,0,0,0,0,0.0,2019,2019,Raja Adeel ,ESP
1840,10,10,0,0,0,0,0,0,0.0,2016,2019,CAK Rajitha ,SL
1841,8,7,0,0,0,0,0,0,0.0,2019,2019,Rakibul Hasan ,ITA
1842,2,2,0,0,0,0,0,0,0.0,2013,2016,RLB Rambukwella ,SL
1843,2,2,0,0,0,0,0,0,0.0,2011,2011,Rameez Raja ,PAK
1844,8,7,0,0,0,0,0,0,0.0,2017,2019,SHA Rance ,NZ
1845,2,2,0,0,0,0,0,0,0.0,2015,2016,DA Rankin ,IRE
1846,3,2,0,0,0,0,0,0,0.0,2015,2016,RJ Ranpura ,OMAN
1847,1,1,0,0,0,0,0,0,0.0,2019,2019,Rashid Khan ,NEPAL
1848,3,3,0,0,0,0,0,0,0.0,2019,2019,KB Ratilal ,PNM
1849,2,2,0,0,0,0,0,0,0.0,2019,2019,Ravinder Singh ,MALTA
1850,4,4,0,0,0,0,0,0,0.0,2019,2019,Razmal Shigiwal ,Aut
1851,2,2,0,0,0,0,0,0,0.0,2014,2014,NJ Reardon ,AUS
1852,2,2,0,0,0,0,0,0,0.0,2019,2019,J Reb ,Serb
1853,4,4,0,0,0,0,0,0,0.0,2019,2019,Riazat Ali Shah ,UGA
1854,1,1,0,0,0,0,0,0,0.0,2007,2007,ACL Richards ,WI
1855,1,1,0,0,0,0,0,0,0.0,2009,2009,DM Richards ,WI
1856,1,1,0,0,0,0,0,0,0.0,2019,2019,EB Ringera ,KENYA
1857,3,3,0,0,0,0,0,0,0.0,2019,2019,R Rivas ,Chile
1858,5,5,0,0,0,0,0,0,0.0,2019,2019,CP Rizwan ,UAE
1859,5,3,0,0,0,0,0,0,0.0,2019,2019,Rizwan Mahmood ,DEN
1860,6,6,0,0,0,0,0,0,0.0,2019,2019,WJR Robertson ,JER
1861,1,1,0,0,0,0,0,0,0.0,2013,2013,Robiul Islam ,BDESH
1862,2,2,0,0,0,0,0,0,0.0,2008,2009,GA Rogers ,SCOT
1863,1,1,0,0,0,0,0,0,0.0,2013,2013,BJ Rohrer ,AUS
1864,3,3,0,0,0,0,0,0,0.0,2015,2015,Rokhan Barakzai ,AFG
1865,1,1,0,0,0,0,0,0,0.0,2015,2015,Rony Talukdar ,BDESH
1866,1,1,0,0,0,0,0,0,0.0,2006,2006,JA Rudolph ,SA
1867,6,6,0,0,0,0,0,0,0.0,2019,2019,SI Runsewe ,NGA
1868,1,1,0,0,0,0,0,0,0.0,2018,2018,AK Sah ,NEPAL
1869,4,4,0,0,0,0,0,0,0.0,2019,2019,TK Saha ,Fin
1870,2,2,0,0,0,0,0,0,0.0,2019,2019,Sajid Liaqat ,GER
1871,2,2,0,0,0,0,0,0,0.0,2019,2019,Sakib Hasan ,Serb
1872,2,2,0,0,0,0,0,0,0.0,2019,2019,BA Sambo ,Moz
1873,3,3,0,0,0,0,0,0,0.0,2019,2019,O Sam Arthur ,CRC
1874,2,2,0,0,0,0,0,0,0.0,2015,2015,Sandeep Sharma ,INDIA
1875,2,2,0,0,0,0,0,0,0.0,2019,2019,Saqlain Ali ,Belg
1876,1,1,0,0,0,0,0,0,0.0,2016,2016,Saqlain Sajib ,BDESH
1877,4,4,0,0,0,0,0,0,0.0,2019,2019,Sarfaraz Ali ,BAH
1878,4,4,0,0,0,0,0,0,0.0,2019,2019,R Satheesan ,ROM
1879,2,2,0,0,0,0,0,0,0.0,2019,2019,JOP Scamans ,Fin
1880,2,2,0,0,0,0,0,0,0.0,2019,2019,K Senamontree ,THAI
1881,6,6,0,0,0,0,0,0,0.0,2019,2019,YSD Seneveratne ,Caym
1882,4,4,0,0,0,0,0,0,0.0,2019,2019,M Sert ,TKY
1883,1,1,0,0,0,0,0,0,0.0,2007,2007,Shabbir Ahmed ,PAK
1884,1,1,0,0,0,0,0,0,0.0,2012,2012,Shabir Noori ,AFG
1885,3,3,0,0,0,0,0,0,0.0,2019,2019,L Shafeeg ,Mald
1886,6,6,0,0,0,0,0,0,0.0,2006,2013,Shahadat Hossain ,BDESH
1887,3,3,0,0,0,0,0,0,0.0,2019,2019,Shahbaz Badar ,BAH
1888,2,2,0,0,0,0,0,0,0.0,2019,2019,Shahzad Muhammad ,Mex
1889,1,1,0,0,0,0,0,0,0.0,2014,2014,Sharif Asadullah ,UAE
1890,1,1,0,0,0,0,0,0,0.0,2014,2014,KV Sharma ,INDIA
1891,2,2,0,0,0,0,0,0,0.0,2012,2012,R Sharma ,INDIA
1892,5,5,0,0,0,0,0,0,0.0,2019,2019,ZK Shem ,VAN
1893,4,4,0,0,0,0,0,0,0.0,2019,2019,Shoaib Gazi Hossain ,Chile
1894,2,2,0,0,0,0,0,0,0.0,2009,2010,PM Siddle ,AUS
1895,3,3,0,0,0,0,0,0,0.0,2019,2019,KM Silva ,
1896,2,2,0,0,0,0,0,0,0.0,2019,2019,BA Simango ,Moz
1897,3,3,0,0,0,0,0,0,0.0,2019,2019,LA Simango ,Moz
1898,2,2,0,0,0,0,0,0,0.0,2019,2019,M Simmons ,BMUDA
1899,1,1,0,0,0,0,0,0,0.0,2019,2019,Simranjit Singh ,ITA
1900,2,2,0,0,0,0,0,0,0.0,2005,2007,MS Sinclair ,NZ
1901,7,7,0,0,0,0,0,0,0.0,2019,2019,H Singh ,GER
1902,4,4,0,0,0,0,0,0,0.0,2019,2019,S Singh ,PHI
1903,1,1,0,0,0,0,0,0,0.0,2019,2019,S Singh ,PORT
1904,3,3,0,0,0,0,0,0,0.0,2019,2019,JR Singleton ,
1905,2,2,0,0,0,0,0,0,0.0,2019,2019,T Singye ,BHU
1906,4,4,0,0,0,0,0,0,0.0,2019,2019,RM Siri ,Arg
1907,4,4,0,0,0,0,0,0,0.0,2019,2019,DC Smith ,PHI
1908,2,2,0,0,0,0,0,0,0.0,2018,2018,OF Smith ,WI
1909,2,2,0,0,0,0,0,0,0.0,2019,2019,RAJ Smith ,SCOT
1910,5,5,0,0,0,0,0,0,0.0,2008,2017,Sohail Khan ,PAK
1911,3,3,0,0,0,0,0,0,0.0,2019,2019,S Sohal ,USA
1912,1,1,0,0,0,0,0,0,0.0,2019,2019,Soheel Hussain ,Belg
1913,2,2,0,0,0,0,0,0,0.0,2019,2019,M Sohel Patel ,PNM
1914,1,1,0,0,0,0,0,0,0.0,2010,2010,Sohrawordi Shuvo ,BDESH
1915,4,4,0,0,0,0,0,0,0.0,2019,2019,S Sola ,Samoa
1916,1,1,0,0,0,0,0,0,0.0,2019,2019,S Soosiyakumar ,
1917,1,1,0,0,0,0,0,0,0.0,2019,2019,ES Soto ,CRC
1918,4,4,0,0,0,0,0,0,0.0,2019,2019,M Spry ,Peru
1919,2,2,0,0,0,0,0,0,0.0,2016,2016,BB Sran ,INDIA
1920,1,1,0,0,0,0,0,0,0.0,2017,2017,L Sreekumar ,UAE
1921,4,4,0,0,0,0,0,0,0.0,2019,2019,H Ssenyondo ,UGA
1922,9,9,0,0,0,0,0,0,0.0,2019,2019,AJ Staal ,NL
1923,19,19,0,0,0,0,0,0,0.0,2017,2019,B Stanlake ,AUS
1924,2,2,0,0,0,0,0,0,0.0,2019,2019,AL Stephen ,VAN
1925,3,3,0,0,0,0,0,0,0.0,2019,2019,BS Stephenson ,Blz
1926,1,1,0,0,0,0,0,0,0.0,2019,2019,TJ Stephenson ,Blz
1927,2,2,0,0,0,0,0,0,0.0,2019,2019,Suhail Sadiq ,LUX
1928,1,1,0,0,0,0,0,0,0.0,2019,2019,Suhrid Roy ,MALTA
1929,1,1,0,0,0,0,0,0,0.0,2019,2019,Sumair Khan ,MALTA
1930,2,2,0,0,0,0,0,0,0.0,2019,2019,Suresh Kumar ,Peru
1931,4,4,0,0,0,0,0,0,0.0,2008,2008,ZE Surkari ,CAN
1932,1,1,0,0,0,0,0,0,0.0,2018,2018,MJ Swepson ,AUS
1933,2,2,0,0,0,0,0,0,0.0,2019,2019,Syazrul Idrus ,MAL
1934,5,5,0,0,0,0,0,0,0.0,2019,2019,Tafseer Ali ,NOR
1935,2,2,0,0,0,0,0,0,0.0,2019,2019,Taijul Islam ,BDESH
1936,1,1,0,0,0,0,0,0,0.0,2019,2019,Talha Khan ,GER
1937,1,1,0,0,0,0,0,0,0.0,2010,2010,Tanvir Ahmed ,PAK
1938,4,4,0,0,0,0,0,0,0.0,2019,2019,Tariq Aziz ,PORT
1939,8,8,0,0,0,0,0,0,0.0,2019,2019,Tarun Sharma ,Mex
1940,3,3,0,0,0,0,0,0,0.0,2006,2007,R Telemachus ,SA
1941,6,5,0,0,0,0,0,0,0.0,2019,2019,VE Tembo ,Moz
1942,1,1,0,0,0,0,0,0,0.0,2019,2019,H Thaker ,CAN
1943,2,2,0,0,0,0,0,0,0.0,2019,2019,J Thinley ,BHU
1944,1,1,0,0,0,0,0,0,0.0,2007,2007,AC Thomas ,SA
1945,10,10,0,0,0,0,0,0,0.0,2018,2019,O Thomas ,WI
1946,1,1,0,0,0,0,0,0,0.0,2008,2008,EP Thompson ,NZ
1947,3,3,0,0,0,0,0,0,0.0,2008,2008,S Thuraisingam ,CAN
1948,4,4,0,0,0,0,0,0,0.0,2019,2019,SF Tiai ,Samoa
1949,3,3,0,0,0,0,0,0,0.0,2019,2019,BM Tickner ,NZ
1950,1,1,0,0,0,0,0,0,0.0,2007,2007,CT Tremlett ,ENG
1951,7,7,0,0,0,0,0,0,0.0,2007,2010,IJL Trott ,ENG
1952,15,15,0,0,0,0,0,0,0.0,2008,2019,RJ Trott ,BMUDA
1953,1,1,0,0,0,0,0,0,0.0,2008,2008,TE Tucker ,BMUDA
1954,3,3,0,0,0,0,0,0,0.0,2005,2010,DR Tuffey ,NZ
1955,4,4,0,0,0,0,0,0,0.0,2019,2019,T Turan ,TKY
1956,2,2,0,0,0,0,0,0,0.0,2019,2019,HER Tyler ,PHI
1957,8,8,0,0,0,0,0,0,0.0,2008,2017,ML Udawatte ,SL
1958,3,3,0,0,0,0,0,0,0.0,2019,2019,T Ulutuna ,TKY
1959,4,4,0,0,0,0,0,0,0.0,2019,2019,R Ulutuna ,TKY
1960,3,3,0,0,0,0,0,0,0.0,2015,2015,Umair Ali ,UAE
1961,7,7,0,0,0,0,0,0,0.0,2019,2019,J Umanath ,Mex
1962,3,3,0,0,0,0,0,0,0.0,2016,2016,Usman Mushtaq ,UAE
1963,6,6,0,0,0,0,0,0,0.0,2006,2007,WPUJC Vaas ,SL
1964,8,8,0,0,0,0,0,0,0.0,2006,2007,JJ van der Wath ,SA
1965,3,3,0,0,0,0,0,0,0.0,2009,2009,VB van Jaarsveld ,SA
1966,3,3,0,0,0,0,0,0,0.0,2019,2019,S Varathappan ,KUW
1967,2,2,0,0,0,0,0,0,0.0,2005,2007,MP Vaughan ,ENG
1968,3,3,0,0,0,0,0,0,0.0,2019,2019,G Venkateswaran ,LUX
1969,3,3,0,0,0,0,0,0,0.0,2019,2019,JK Vifah ,Ghana
1970,4,4,0,0,0,0,0,0,0.0,2019,2019,V Vijh ,LUX
1971,1,1,0,0,0,0,0,0,0.0,2019,2019,Vikramjit Singh ,NL
1972,1,1,0,0,0,0,0,0,0.0,2012,2012,DJ Vilas ,SA
1973,6,6,0,0,0,0,0,0,0.0,2019,2019,TC Vine ,ESP
1974,2,2,0,0,0,0,0,0,0.0,2019,2019,R Vishwanath ,LUX
1975,1,1,0,0,0,0,0,0,0.0,2019,2019,C Vorster ,GUE
1976,4,4,0,0,0,0,0,0,0.0,2019,2019,Walid Ghauri ,NOR
1977,2,2,0,0,0,0,0,0,0.0,2019,2019,T Wangchuk jnr ,BHU
1978,5,5,0,0,0,0,0,0,0.0,2019,2019,S Waqas Ahmed ,NOR
1979,8,8,0,0,0,0,0,0,0.0,2014,2017,Waqas Khan ,HKG
1980,1,1,0,0,0,0,0,0,0.0,2018,2018,Waqas Maqsood ,PAK
1981,1,1,0,0,0,0,0,0,0.0,2019,2019,Waqas Raja ,Fin
1982,4,4,0,0,0,0,0,0,0.0,2013,2013,I Wardlaw ,SCOT
1983,1,1,0,0,0,0,0,0,0.0,2019,2019,Wasim Ali ,OMAN
1984,5,5,0,0,0,0,0,0,0.0,2019,2019,SMK Waththage ,CZK-R
1985,2,2,0,0,0,0,0,0,0.0,2010,2010,UWMBCA Welegedara ,SL
1986,4,4,0,0,0,0,0,0,0.0,2019,2019,T Whiteman ,LUX
1987,3,3,0,0,0,0,0,0,0.0,2018,2018,SG Whittingham ,SCOT
1988,3,3,0,0,0,0,0,0,0.0,2007,2007,G Wijekoon ,SL
1989,1,1,0,0,0,0,0,0,0.0,2005,2005,JW Wilson ,NZ
1990,5,5,0,0,0,0,0,0,0.0,2015,2019,MA Wood ,ENG
1991,2,2,0,0,0,0,0,0,0.0,2015,2015,Yamin Ahmadzai ,AFG
1992,2,2,0,0,0,0,0,0,0.0,2019,2019,N Yordanov ,
1993,3,3,0,0,0,0,0,0,0.0,2019,2019,Zain ul Tashnam ,CRC
1994,1,1,0,0,0,0,0,0,0.0,2018,2018,Zakir Hasan ,BDESH
1995,3,3,0,0,0,0,0,0,0.0,2019,2019,Zaki Ul Hassan ,Belg
1996,1,1,0,0,0,0,0,0,0.0,2012,2012,Zamir Khan ,AFG
1997,1,1,0,0,0,0,0,0,0.0,2019,2019,S Zargar ,Mex
1998,5,5,0,0,0,0,0,0,0.0,2015,2015,Zeeshan Siddiqui ,OMAN
1999,4,4,0,0,0,0,0,0,0.0,2019,2019,Zeshan Arif ,Aut
2000,1,1,0,0,0,0,0,0,0.000,2019,2019,Ziaur Rahman ,AFG
2001,1,1,0,0,0,0,0,0,0.000,2019,2019,Ziaur Rehman ,Fin
2002,4,4,0,0,0,0,0,0,0.000,2019,2019,Zohaib Sarwar ,PORT
2003,1,1,0,0,0,0,0,0,0.000,2006,2006,M Zondeki ,SA
2004,1,-1,-1,-1,-1,-1,-1,-1,-1,2008,2008,GMC Mol ,NL
2005,1,-1,-1,-1,-1,-1,-1,-1,-1,2008,2008,JD Schoonheim ,NL
