,Mat,Inns,Dis,Ct,St,Ct Wk,Ct Fi,MD,D/I,start,end,name,country
0,147,281,555,532,23,532,0,6 (6ct 0st),1.975,1997,2012,MV Boucher ,SA
1,96,191,416,379,37,379,0,5 (5ct 0st),2.178,1999,2008,AC Gilchrist ,AUS
2,119,224,395,366,29,366,0,6 (6ct 0st),1.763,1988,1999,IA Healy ,AUS
3,96,182,355,343,12,343,0,6 (6ct 0st),1.95,1970,1984,RW Marsh ,AUS
4,90,166,294,256,38,256,0,6 (6ct 0st),1.771,2005,2014,MS Dhoni ,INDIA
5,133,231,277,263,14,227,36,6 (6ct 0st),1.199,1990,2003,AJ Stewart ,ENG
6,81,154,272,267,5,265,2,5 (5ct 0st),1.766,1981,1991,PJL Dujon ,WI
7,66,128,270,262,8,262,0,6 (6ct 0st),2.109,2008,2015,BJ Haddin ,AUS
8,95,174,269,250,19,250,0,5 (4ct 1st),1.545,1967,1981,APE Knott ,ENG
9,79,146,256,243,13,243,0,6 (6ct 0st),1.753,2007,2014,MJ Prior ,ENG
10,67,127,236,228,8,218,10,6 (6ct 0st),1.858,2009,2019,BJ Watling ,NZ
11,81,146,228,201,27,201,0,7 (7ct 0st),1.561,1967,1984,Wasim Bari ,PAK
12,114,217,227,222,5,101,121,6 (6ct 0st),1.046,2004,2018,AB de Villiers ,SA
13,91,175,219,173,46,173,0,4 (4ct 0st),1.251,1946,1959,TG Evans ,ENG
14,65,122,219,207,12,207,0,7 (7ct 0st),1.795,1998,2004,RD Jacobs ,WI
15,74,131,217,205,12,205,0,5 (5ct 0st),1.656,2005,2016,D Ramdin ,WI
16,164,301,210,210,0,0,210,3 (3ct 0st),0.6970000000000001,1996,2012,R Dravid ,INDIA
17,101,186,209,198,11,168,30,5 (5ct 0st),1.123,2004,2016,BB McCullum ,NZ
18,53,99,206,184,22,184,0,5 (5ct 0st),2.08,2002,2010,Kamran Akmal ,PAK
19,149,270,205,205,0,0,205,4 (4ct 0st),0.759,1997,2014,DPMD Jayawardene ,SL
20,78,138,204,197,7,194,3,5 (5ct 0st),1.4780000000000002,1990,2002,AC Parore ,NZ
21,134,248,202,182,20,131,51,5 (5ct 0st),0.8140000000000001,2000,2015,KC Sangakkara ,SL
22,166,315,200,200,0,0,200,4 (4ct 0st),0.634,1995,2013,JH Kallis ,SA
23,88,151,198,160,38,160,0,6 (5ct 1st),1.311,1976,1986,SMH Kirmani ,INDIA
24,70,132,197,184,13,173,11,6 (6ct 0st),1.492,2012,2019,JM Bairstow ,ENG
25,168,328,196,196,0,0,196,3 (3ct 0st),0.597,1995,2012,RT Ponting ,AUS
26,62,119,189,181,8,181,0,5 (5ct 0st),1.588,1963,1980,DL Murray ,WI
27,44,82,187,176,11,176,0,6 (6ct 0st),2.28,2014,2019,Q de Kock ,SA
28,51,98,187,163,24,163,0,6 (6ct 0st),1.908,1957,1966,ATW Grout ,AUS
29,128,245,181,181,0,0,181,4 (4ct 0st),0.738,1991,2002,ME Waugh ,AUS
30,63,109,176,168,8,168,0,7 (7ct 0st),1.614,1980,1992,IDS Smith ,NZ
31,161,300,175,175,0,0,175,3 (3ct 0st),0.583,2006,2018,AN Cook ,ENG
32,57,106,174,167,7,167,0,7 (7ct 0st),1.641,1971,1984,RW Taylor ,ENG
33,111,199,171,171,0,0,171,5 (5ct 0st),0.8590000000000001,1994,2008,SP Fleming ,NZ
34,117,225,169,169,0,0,169,5 (5ct 0st),0.7509999999999999,2002,2014,GC Smith ,SA
35,49,94,167,146,21,146,0,5 (5ct 0st),1.776,2010,2019,Sarfaraz Ahmed ,PAK
36,54,96,165,153,12,153,0,6 (6ct 0st),1.7180000000000002,1988,1998,RC Russell ,ENG
37,131,241,164,164,0,0,164,4 (4ct 0st),0.68,1990,2006,BC Lara ,WI
38,63,110,160,151,9,142,9,5 (5ct 0st),1.454,1992,2002,A Flower ,ZIM
39,104,197,157,157,0,0,157,4 (4ct 0st),0.7959999999999999,1989,1999,MA Taylor ,AUS
40,156,277,156,156,0,0,156,4 (4ct 0st),0.563,1978,1994,AR Border ,AUS
41,58,102,156,124,32,124,0,5 (5ct 0st),1.529,2000,2015,HAPW Jayawardene ,SL
42,42,77,152,150,2,150,0,5 (5ct 0st),1.974,1992,1998,DJ Richardson ,SA
43,69,124,148,128,20,127,1,5 (4ct 1st),1.193,1990,2004,Moin Khan ,PAK
44,98,184,143,143,0,0,143,3 (3ct 0st),0.777,2007,2019,LRPL Taylor ,NZ
45,50,94,141,124,17,124,0,4 (4ct 0st),1.5,1951,1965,JHB Waite ,SA
46,118,221,139,139,0,0,139,4 (4ct 0st),0.628,2000,2017,Younis Khan ,PAK
47,30,58,137,131,6,131,0,5 (5ct 0st),2.362,2010,2019,TD Paine ,AUS
48,134,248,135,135,0,0,135,4 (4ct 0st),0.544,1996,2012,VVS Laxman ,INDIA
49,115,223,134,134,0,0,134,3 (3ct 0st),0.6,2004,2015,MJ Clarke ,AUS
50,34,66,133,128,5,128,0,6 (6ct 0st),2.015,2004,2006,GO Jones ,ENG
51,49,90,130,110,20,110,0,5 (0ct 5st),1.444,1986,1993,KS More ,INDIA
52,54,101,130,78,52,78,0,5 (1ct 4st),1.287,1920,1937,WAS Oldfield ,AUS
53,37,69,130,119,11,119,0,6 (6ct 0st),1.884,1992,2003,Rashid Latif ,PAK
54,103,205,128,128,0,0,128,4 (4ct 0st),0.624,1994,2009,ML Hayden ,AUS
55,145,281,125,125,0,0,125,3 (3ct 0st),0.444,1992,2007,SK Warne ,AUS
56,83,141,124,122,2,33,89,5 (5ct 0st),0.879,1989,2004,HP Tillakaratne ,SL
57,87,165,122,122,0,0,122,4 (4ct 0st),0.7390000000000001,1970,1984,GS Chappell ,AUS
58,121,232,122,122,0,0,122,4 (4ct 0st),0.525,1974,1991,IVA Richards ,WI
59,100,189,121,121,0,0,121,3 (3ct 0st),0.64,2004,2012,AJ Strauss ,ENG
60,102,179,120,120,0,0,120,3 (3ct 0st),0.67,1977,1992,IT Botham ,ENG
61,114,214,120,120,0,0,120,3 (3ct 0st),0.56,1954,1975,MC Cowdrey ,ENG
62,49,87,119,93,26,93,0,5 (5ct 0st),1.367,1992,2004,RS Kaluwitharana ,SL
63,69,118,118,103,15,98,5,5 (5ct 0st),1.0,2005,2019,Mushfiqur Rahim ,BDESH
64,72,137,117,117,0,0,117,5 (5ct 0st),0.8540000000000001,2010,2019,SPD Smith ,AUS
65,102,189,115,115,0,0,115,4 (4ct 0st),0.608,1987,2002,CL Hooper ,WI
66,200,366,115,115,0,0,115,3 (3ct 0st),0.314,1989,2013,SR Tendulkar ,INDIA
67,46,86,114,103,11,101,2,5 (5ct 0st),1.325,1954,1968,JM Parks ,ENG
68,168,318,112,112,0,0,112,3 (3ct 0st),0.352,1985,2004,SR Waugh ,AUS
69,85,154,110,110,0,0,110,3 (3ct 0st),0.7140000000000001,1927,1947,WR Hammond ,ENG
70,89,168,110,110,0,0,110,4 (4ct 0st),0.654,2012,2019,JE Root ,ENG
71,62,117,110,110,0,0,110,4 (4ct 0st),0.94,1957,1978,RB Simpson ,AUS
72,93,172,109,109,0,0,109,4 (4ct 0st),0.633,1954,1974,GS Sobers ,WI
73,124,234,108,108,0,0,108,3 (3ct 0st),0.461,2004,2019,HM Amla ,SA
74,125,216,108,108,0,0,108,3 (3ct 0st),0.5,1971,1987,SM Gavaskar ,INDIA
75,44,77,107,99,8,99,0,5 (5ct 0st),1.389,1994,2001,NR Mongia ,INDIA
76,99,177,105,105,0,0,105,5 (5ct 0st),0.593,1984,2000,M Azharuddin ,INDIA
77,75,144,105,105,0,0,105,4 (4ct 0st),0.7290000000000001,1964,1980,IM Chappell ,AUS
78,100,179,105,105,0,0,105,4 (4ct 0st),0.586,1993,2005,GP Thorpe ,ENG
79,32,58,104,91,13,91,0,5 (5ct 0st),1.793,1982,1990,Saleem Yousuf ,PAK
80,118,211,103,103,0,0,103,3 (3ct 0st),0.488,1975,1995,GA Gooch ,ENG
81,37,71,103,92,11,92,0,6 (5ct 1st),1.45,2010,2019,WP Saha ,INDIA
82,33,61,102,99,3,98,1,5 (5ct 0st),1.672,1993,2002,JR Murray ,WI
83,35,63,101,81,20,80,1,5 (5ct 0st),1.6030000000000002,2014,2019,N Dickwella ,SL
84,118,223,100,100,0,0,100,3 (3ct 0st),0.4479999999999999,2004,2015,IR Bell ,ENG
85,107,195,99,99,0,0,99,4 (4ct 0st),0.507,1984,1996,DC Boon ,AUS
86,26,51,98,83,15,83,0,5 (5ct 0st),1.921,1951,1956,GRA Langley ,AUS
87,47,87,97,74,23,72,2,4 (4ct 0st),1.114,1929,1939,LEG Ames ,ENG
88,68,124,96,96,0,1,95,4 (4ct 0st),0.774,2003,2011,PD Collingwood ,ENG
89,103,190,96,96,0,0,96,3 (3ct 0st),0.505,2000,2014,CH Gayle ,WI
90,108,208,96,96,0,0,96,3 (3ct 0st),0.461,1974,1991,CG Greenidge ,WI
91,33,59,96,92,4,92,0,5 (5ct 0st),1.6269999999999998,1969,1976,KJ Wadsworth ,NZ
92,76,139,95,95,0,0,95,4 (4ct 0st),0.6829999999999999,2000,2006,ME Trescothick ,ENG
93,90,173,94,94,0,0,94,4 (4ct 0st),0.5429999999999999,1996,2008,HH Gibbs ,SA
94,124,218,94,93,1,0,93,3 (3ct 0st),0.431,1976,1993,Javed Miandad ,PAK
95,41,69,93,77,16,74,3,5 (4ct 1st),1.347,1952,1962,Imtiaz Ahmed ,PAK
96,35,67,92,70,22,70,0,4 (4ct 0st),1.3730000000000002,1896,1909,AFA Lilley ,ENG
97,150,284,91,91,0,0,91,3 (3ct 0st),0.32,2003,2019,JM Anderson ,ENG
98,104,192,91,91,0,0,91,3 (3ct 0st),0.473,2001,2013,V Sehwag ,INDIA
99,25,47,90,85,5,85,0,5 (5ct 0st),1.914,1957,1961,FCM Alexander ,WI
100,65,115,90,90,0,0,90,4 (4ct 0st),0.782,1991,2001,GA Hick ,ENG
101,110,209,90,90,0,0,90,2 (2ct 0st),0.43,1966,1985,CH Lloyd ,WI
102,86,164,90,90,0,0,90,3 (3ct 0st),0.5479999999999999,1983,1995,RB Richardson ,WI
103,87,159,88,88,0,11,77,4 (4ct 0st),0.5529999999999999,1999,2013,TM Dilshan ,SL
104,55,102,87,77,10,62,15,6 (5ct 1st),0.852,2011,2019,LD Chandimal ,SL
105,58,107,87,87,0,0,87,4 (4ct 0st),0.813,1972,1977,AW Greig ,ENG
106,44,61,87,78,9,78,0,4 (4ct 0st),1.426,2000,2007,Khaled Mashud ,BDESH
107,79,153,85,85,0,0,85,3 (3ct 0st),0.555,2005,2013,MEK Hussey ,AUS
108,115,200,83,83,0,0,83,3 (3ct 0st),0.415,1989,2001,MA Atherton ,ENG
109,31,54,83,78,5,78,0,4 (4ct 0st),1.537,2015,2019,SO Dowrich ,WI
110,101,191,83,83,0,0,83,4 (4ct 0st),0.434,1993,2004,G Kirsten ,SA
111,66,123,83,83,0,0,83,3 (3ct 0st),0.674,1964,1976,IR Redpath ,AUS
112,46,83,82,66,16,66,0,3 (3ct 0st),0.987,1961,1975,FM Engineer ,INDIA
113,20,36,81,79,2,79,0,5 (5ct 0st),2.25,1995,2005,CO Browne ,WI
114,120,219,81,81,0,0,81,4 (4ct 0st),0.369,1992,2007,Inzamam-ul-Haq ,PAK
115,79,152,80,80,0,2,78,3 (3ct 0st),0.526,1951,1969,TW Graveney ,ENG
116,84,160,80,80,0,0,80,3 (3ct 0st),0.5,2011,2019,V Kohli ,INDIA
117,63,120,80,80,0,0,80,5 (5ct 0st),0.6659999999999999,2013,2019,AM Rahane ,INDIA
118,31,60,80,69,11,63,6,5 (4ct 1st),1.3330000000000002,2012,2019,MS Wade ,AUS
119,38,72,79,79,0,56,23,5 (5ct 0st),1.097,2014,2019,JC Buttler ,ENG
120,110,196,78,78,0,0,78,3 (3ct 0st),0.397,1991,2007,ST Jayasuriya ,SL
121,116,202,78,78,0,0,78,4 (4ct 0st),0.386,1976,1992,DB Vengsarkar ,INDIA
122,21,41,77,66,11,66,0,6 (6ct 0st),1.878,2010,2014,Adnan Akmal ,PAK
123,30,51,75,70,5,70,0,4 (4ct 0st),1.47,1981,1988,PR Downton ,ENG
124,79,146,75,75,0,0,75,4 (4ct 0st),0.513,1982,1992,AJ Lamb ,ENG
125,117,211,74,74,0,0,74,3 (3ct 0st),0.35,1978,1992,DI Gower ,ENG
126,105,206,73,73,0,0,73,2 (2ct 0st),0.354,1993,2007,JL Langer ,AUS
127,28,50,73,61,12,61,0,4 (2ct 2st),1.46,1910,1926,H Strudwick ,ENG
128,133,233,72,72,0,0,72,2 (2ct 0st),0.309,1992,2010,M Muralitharan ,SL
129,25,47,72,62,10,62,0,4 (4ct 0st),1.531,2002,2018,PA Patel ,INDIA
130,108,205,72,72,0,0,72,3 (3ct 0st),0.351,1995,2008,SM Pollock ,SA
131,73,138,71,71,0,0,71,3 (3ct 0st),0.514,2010,2019,Asad Shafiq ,PAK
132,77,130,71,71,0,0,71,4 (4ct 0st),0.546,1982,1995,MD Crowe ,NZ
133,113,208,71,71,0,0,71,3 (3ct 0st),0.341,1996,2008,SC Ganguly ,INDIA
134,78,147,71,71,0,0,71,3 (3ct 0st),0.482,2010,2019,KS Williamson ,NZ
135,81,147,70,70,0,0,70,2 (2ct 0st),0.476,1996,2006,NJ Astle ,NZ
136,63,116,70,70,0,5,65,4 (4ct 0st),0.603,1964,1983,Majid Khan ,PAK
137,83,160,68,68,0,1,67,4 (4ct 0st),0.425,2011,2019,DA Warner ,AUS
138,70,130,67,67,0,0,67,3 (3ct 0st),0.515,1993,2001,DJ Cullinan ,SA
139,96,165,67,67,0,0,67,3 (3ct 0st),0.406,1990,2004,N Hussain ,ENG
140,164,297,66,66,0,0,66,2 (2ct 0st),0.222,1994,2015,S Chanderpaul ,WI
141,84,152,66,66,0,0,66,3 (3ct 0st),0.434,2009,2019,AD Mathews ,SL
142,63,122,65,65,0,0,65,3 (3ct 0st),0.532,1952,1964,R Benaud ,AUS
143,28,55,65,44,21,44,0,4 (4ct 0st),1.181,1907,1921,H Carter ,AUS
144,116,221,65,65,0,0,65,2 (2ct 0st),0.294,1978,1994,DL Haynes ,WI
145,90,168,65,65,0,0,65,3 (3ct 0st),0.386,1998,2010,Mohammad Yousuf ,PAK
146,103,184,65,65,0,0,65,3 (3ct 0st),0.353,1982,1999,Saleem Malik ,PAK
147,38,68,65,65,0,0,65,5 (5ct 0st),0.955,2007,2013,DJG Sammy ,WI
148,52,97,64,64,0,0,64,3 (3ct 0st),0.659,1974,1987,JV Coney ,NZ
149,79,152,64,64,0,0,64,4 (4ct 0st),0.421,1948,1963,RN Harvey ,AUS
150,131,230,64,64,0,0,64,2 (2ct 0st),0.278,1978,1994,N Kapil Dev ,INDIA
151,67,128,64,64,0,0,64,3 (3ct 0st),0.5,1952,1965,FS Trueman ,ENG
152,44,82,64,53,11,27,26,4 (3ct 1st),0.78,1948,1960,CL Walcott ,WI
153,64,113,64,64,0,1,63,4 (4ct 0st),0.5660000000000001,1909,1934,FE Woolley ,ENG
154,26,49,63,57,6,51,6,4 (4ct 0st),1.285,2004,2018,KD Karthik ,INDIA
155,36,67,63,43,20,43,0,4 (4ct 0st),0.94,1896,1905,JJ Kelly ,AUS
156,42,76,63,63,0,5,58,4 (4ct 0st),0.828,2015,2019,BKG Mendis ,SL
157,17,31,63,61,2,61,0,4 (4ct 0st),2.032,2015,2016,PM Nevill ,AUS
158,91,159,63,63,0,0,63,3 (3ct 0st),0.396,1969,1983,GR Viswanath ,INDIA
159,60,111,62,62,0,0,62,2 (2ct 0st),0.5579999999999999,2012,2019,D Elgar ,SA
160,59,112,62,62,0,0,62,4 (4ct 0st),0.5529999999999999,1968,1977,RC Fredericks ,WI
161,19,34,62,57,5,57,0,5 (5ct 0st),1.823,1978,1982,DA Murray ,WI
162,104,193,62,62,0,0,62,3 (3ct 0st),0.321,2005,2014,KP Pietersen ,ENG
163,60,114,62,62,0,0,62,3 (3ct 0st),0.5429999999999999,2013,2019,BA Stokes ,ENG
164,28,42,62,57,5,55,2,4 (4ct 0st),1.476,2001,2012,T Taibu ,ZIM
165,77,145,61,61,0,0,61,3 (3ct 0st),0.42,2010,2019,Azhar Ali ,PAK
166,35,62,61,37,24,35,2,4 (2ct 2st),0.983,1877,1894,JM Blackham ,AUS
167,71,122,61,61,0,0,61,3 (3ct 0st),0.5,1997,2004,MA Butcher ,ENG
168,60,105,60,60,0,0,60,3 (3ct 0st),0.5710000000000001,1992,2002,ADR Campbell ,ZIM
169,24,43,60,45,15,45,0,4 (4ct 0st),1.395,1924,1936,G Duckworth ,ENG
170,132,242,60,60,0,0,60,2 (2ct 0st),0.247,1990,2008,A Kumble ,INDIA
171,58,110,60,60,0,0,60,4 (4ct 0st),0.545,1899,1930,W Rhodes ,ENG
172,16,30,60,56,4,56,0,5 (5ct 0st),2.0,1966,1970,HB Taber ,AUS
173,79,135,59,59,0,0,59,3 (3ct 0st),0.437,1978,1995,MW Gatting ,ENG
174,21,42,59,52,7,52,0,5 (5ct 0st),1.404,1976,1983,WK Lees ,NZ
175,19,36,59,57,2,54,3,6 (6ct 0st),1.638,1963,1970,DT Lindsay ,SA
176,49,93,59,59,0,0,59,3 (3ct 0st),0.634,1952,1968,GAR Lock ,ENG
177,90,159,58,58,0,0,58,3 (3ct 0st),0.364,1990,2007,MS Atapattu ,SL
178,82,153,58,58,0,0,58,3 (3ct 0st),0.379,1955,1968,KF Barrington ,ENG
179,21,42,58,50,8,50,0,4 (4ct 0st),1.38,1946,1953,D Tallon ,AUS
180,113,205,58,58,0,0,58,3 (3ct 0st),0.282,1997,2014,DL Vettori ,NZ
181,79,147,57,57,0,0,57,3 (3ct 0st),0.387,1937,1955,L Hutton ,ENG
182,52,98,57,57,0,0,57,4 (4ct 0st),0.581,1983,1991,AL Logie ,WI
183,62,115,56,56,0,0,56,3 (3ct 0st),0.486,2012,2019,F du Plessis ,SA
184,52,81,56,56,0,0,56,4 (4ct 0st),0.691,1986,1998,RS Mahanama ,SL
185,42,71,56,56,0,0,56,4 (4ct 0st),0.7879999999999999,1929,1949,B Mitchell ,SA
186,21,38,55,52,3,52,0,6 (6ct 0st),1.4469999999999998,1961,1967,JT Murray ,ENG
187,59,106,54,54,0,0,54,3 (3ct 0st),0.509,1968,1982,KWR Fletcher ,ENG
188,19,36,54,50,4,50,0,4 (4ct 0st),1.5,1959,1969,BN Jarman ,AUS
189,58,111,54,54,0,0,54,3 (3ct 0st),0.486,2000,2009,ND McKenzie ,SA
190,15,26,54,48,6,48,0,6 (6ct 0st),2.076,1999,2007,CMW Read ,ENG
191,60,113,54,54,0,0,54,3 (3ct 0st),0.477,2008,2013,GP Swann ,ENG
192,35,58,54,54,0,0,54,3 (3ct 0st),0.931,1993,1999,BA Young ,NZ
193,11,22,53,51,2,51,0,6 (6ct 0st),2.4090000000000003,2018,2019,RR Pant ,INDIA
194,87,162,53,53,0,0,53,2 (2ct 0st),0.327,2000,2011,RR Sarwan ,WI
195,50,91,53,53,0,0,53,3 (3ct 0st),0.5820000000000001,1958,1972,MJK Smith ,ENG
196,27,50,53,53,0,0,53,4 (4ct 0st),1.06,1969,1977,ED Solkar ,INDIA
197,39,75,52,52,0,0,52,3 (3ct 0st),0.693,1976,1981,JM Brearley ,ENG
198,79,144,52,52,0,0,52,3 (3ct 0st),0.361,1998,2009,A Flintoff ,ENG
199,79,151,52,52,0,0,52,3 (3ct 0st),0.344,1958,1976,LR Gibbs ,WI
200,27,43,52,52,0,43,9,5 (5ct 0st),1.209,1983,1986,WB Phillips ,AUS
201,71,135,52,52,0,0,52,2 (2ct 0st),0.385,2008,2019,TG Southee ,NZ
202,44,77,51,51,0,0,51,4 (4ct 0st),0.662,1997,2004,RP Arnold ,SL
203,54,94,51,51,0,0,51,5 (5ct 0st),0.542,2010,2019,DM Bravo ,WI
204,26,45,51,39,12,39,0,4 (2ct 2st),1.133,1927,1935,HB Cameron ,SA
205,17,30,51,47,4,47,0,4 (4ct 0st),1.7,1961,1965,AE Dick ,NZ
206,66,124,51,51,0,0,51,2 (2ct 0st),0.411,1972,1981,AI Kallicharran ,WI
207,21,35,51,35,16,35,0,4 (4ct 0st),1.457,1955,1961,NS Tamhane ,INDIA
208,47,88,50,50,0,0,50,3 (3ct 0st),0.568,2009,2016,MJ Guptill ,NZ
209,70,126,50,50,0,0,50,3 (3ct 0st),0.396,1977,1984,KJ Hughes ,AUS
210,79,147,50,50,0,6,44,3 (3ct 0st),0.34,1957,1974,RB Kanhai ,WI
211,64,118,50,50,0,0,50,3 (3ct 0st),0.423,2012,2019,FDM Karunaratne ,SL
212,75,143,50,50,0,0,50,3 (3ct 0st),0.349,2001,2017,Misbah-ul-Haq ,PAK
213,75,144,50,50,0,0,50,3 (3ct 0st),0.347,2010,2019,CA Pujara ,INDIA
214,78,146,49,49,0,0,49,2 (2ct 0st),0.335,1937,1957,DCS Compton ,ENG
215,38,70,49,49,0,0,49,3 (3ct 0st),0.7,1992,1998,BM McMillan ,SA
216,11,22,49,46,3,46,0,4 (4ct 0st),2.227,1994,1995,SJ Rhodes ,ENG
217,61,115,49,49,0,0,49,2 (2ct 0st),0.426,2008,2018,M Vijay ,INDIA
218,48,90,49,49,0,0,49,4 (4ct 0st),0.544,1948,1958,ED Weekes ,WI
219,54,99,48,48,0,0,48,4 (4ct 0st),0.484,1992,2001,JC Adams ,WI
220,21,38,48,43,5,43,0,5 (4ct 1st),1.263,2003,2012,CS Baugh ,WI
221,41,77,48,48,0,0,48,4 (4ct 0st),0.623,1955,1970,TL Goddard ,SA
222,49,94,48,48,0,7,41,3 (3ct 0st),0.51,2014,2019,TWM Latham ,NZ
223,76,133,48,48,0,0,48,2 (2ct 0st),0.36,1976,1989,Mudassar Nazar ,PAK
224,44,83,48,48,0,4,44,4 (4ct 0st),0.578,2001,2014,Taufeeq Umar ,PAK
225,69,115,47,47,0,0,47,3 (3ct 0st),0.408,1969,1988,M Amarnath ,INDIA
226,52,92,47,47,0,0,47,3 (3ct 0st),0.51,1995,2002,SL Campbell ,WI
227,20,37,47,42,5,42,0,4 (2ct 2st),1.27,1962,1969,JL Hendriks ,WI
228,95,184,47,47,0,0,47,2 (2ct 0st),0.255,2011,2019,NM Lyon ,AUS
229,66,124,47,47,0,0,47,3 (3ct 0st),0.379,2002,2011,AG Prince ,SA
230,93,148,47,47,0,0,47,3 (3ct 0st),0.317,1982,2000,A Ranatunga ,SL
231,13,24,47,42,5,42,0,4 (4ct 0st),1.958,1977,1985,SJ Rixon ,AUS
232,43,83,47,47,0,0,47,3 (3ct 0st),0.5660000000000001,1966,1974,KR Stackpole ,AUS
233,36,70,46,46,0,1,45,4 (4ct 0st),0.657,2014,2019,KL Rahul ,INDIA
234,37,69,46,46,0,0,46,4 (4ct 0st),0.6659999999999999,1966,1974,AL Wadekar ,INDIA
235,46,90,45,45,0,0,45,3 (3ct 0st),0.5,1995,2000,GS Blewett ,AUS
236,31,56,45,44,1,9,35,5 (5ct 0st),0.8029999999999999,2015,2019,SD Hope ,WI
237,60,110,45,45,0,0,45,3 (3ct 0st),0.409,1987,2001,Ijaz Ahmed ,PAK
238,61,115,45,45,0,0,45,3 (3ct 0st),0.391,1958,1973,R Illingworth ,ENG
239,55,107,45,45,0,0,45,2 (2ct 0st),0.42,2003,2018,Mohammad Hafeez ,PAK
240,81,145,45,45,0,0,45,3 (3ct 0st),0.31,2001,2013,TT Samaraweera ,SL
241,32,61,45,45,0,0,45,3 (3ct 0st),0.737,1890,1904,H Trumble ,AUS
242,59,113,45,45,0,0,45,3 (3ct 0st),0.3979999999999999,2005,2015,SR Watson ,AUS
243,50,96,44,44,0,0,44,2 (2ct 0st),0.4579999999999999,1902,1921,WW Armstrong ,AUS
244,61,110,44,44,0,1,43,3 (3ct 0st),0.4,1965,1978,BE Congdon ,NZ
245,58,90,44,43,1,4,39,3 (3ct 0st),0.488,1949,1965,JR Reid ,NZ
246,86,157,44,44,0,0,44,3 (3ct 0st),0.28,1966,1982,DL Underwood ,ENG
247,82,150,44,44,0,0,44,3 (3ct 0st),0.293,1999,2008,MP Vaughan ,ENG
248,57,101,44,44,0,0,44,4 (4ct 0st),0.435,1965,1983,S Venkataraghavan ,INDIA
249,104,186,44,44,0,0,44,3 (3ct 0st),0.236,1985,2002,Wasim Akram ,PAK
250,135,253,43,43,0,0,43,2 (2ct 0st),0.1689999999999999,2007,2019,SCJ Broad ,ENG
251,93,149,43,43,0,0,43,4 (4ct 0st),0.288,1984,2002,PA de Silva ,SL
252,77,145,43,43,0,0,43,2 (2ct 0st),0.296,1963,1976,JH Edrich ,ENG
253,67,114,43,43,0,0,43,3 (3ct 0st),0.377,1992,2004,GW Flower ,ZIM
254,45,78,43,43,0,0,43,4 (4ct 0st),0.551,1902,1924,AW Nourse ,SA
255,74,142,43,43,0,0,43,2 (2ct 0st),0.302,1965,1981,KD Walters ,AUS
256,51,98,43,43,0,0,43,3 (3ct 0st),0.4379999999999999,1948,1963,FMM Worrell ,WI
257,44,85,42,42,0,0,42,4 (4ct 0st),0.494,1953,1963,AK Davidson ,AUS
258,51,91,42,42,0,0,42,4 (4ct 0st),0.461,1975,1987,PH Edmonds ,ENG
259,58,111,42,42,0,0,42,3 (3ct 0st),0.3779999999999999,1977,1987,J Garner ,WI
260,103,192,42,42,0,0,42,2 (2ct 0st),0.218,1998,2015,Harbhajan Singh ,INDIA
261,50,89,42,42,0,0,42,3 (3ct 0st),0.471,1976,1988,Iqbal Qasim ,PAK
262,66,127,42,42,0,0,42,4 (4ct 0st),0.33,1951,1961,PBH May ,ENG
263,57,102,42,42,0,0,42,2 (2ct 0st),0.411,1959,1979,Mushtaq Mohammad ,PAK
264,37,73,42,42,0,0,42,4 (4ct 0st),0.575,1961,1972,PH Parfitt ,ENG
265,41,75,42,42,0,0,42,2 (2ct 0st),0.56,1969,1983,GM Turner ,NZ
266,11,19,42,40,2,40,0,5 (5ct 0st),2.21,1992,1998,D Williams ,WI
267,40,71,41,41,0,0,41,3 (3ct 0st),0.5770000000000001,2004,2010,DJ Bravo ,WI
268,39,69,41,41,0,0,41,4 (4ct 0st),0.594,1983,1990,JJ Crowe ,NZ
269,28,52,41,41,0,3,38,3 (3ct 0st),0.7879999999999999,1951,1958,WR Endean ,SA
270,39,73,41,41,0,0,41,3 (3ct 0st),0.561,1930,1938,SJ McCabe ,AUS
271,59,108,41,41,0,0,41,2 (2ct 0st),0.379,1978,1988,GM Wood ,AUS
272,55,95,40,40,0,2,38,4 (4ct 0st),0.421,1952,1969,Hanif Mohammad ,PAK
273,40,72,40,40,0,0,40,2 (2ct 0st),0.555,2001,2013,Imran Farhat ,PAK
274,43,78,40,40,0,0,40,5 (5ct 0st),0.512,1981,1992,K Srikkanth ,INDIA
275,23,44,39,39,0,0,39,4 (4ct 0st),0.8859999999999999,1901,1908,LC Braund ,ENG
276,39,70,39,39,0,0,39,3 (3ct 0st),0.557,1938,1955,WJ Edrich ,ENG
277,16,25,39,38,1,38,0,4 (4ct 0st),1.56,1986,1988,BN French ,ENG
278,22,42,39,39,0,1,38,3 (3ct 0st),0.928,1880,1899,WG Grace ,ENG
279,86,156,39,39,0,0,39,2 (2ct 0st),0.25,1973,1990,Sir RJ Hadlee ,NZ
280,56,109,39,39,0,0,39,2 (2ct 0st),0.357,2001,2010,SM Katich ,AUS
281,52,93,39,39,0,0,39,3 (3ct 0st),0.419,1991,2002,MR Ramprakash ,ENG
282,62,110,39,39,0,0,39,3 (3ct 0st),0.354,1988,1996,RA Smith ,ENG
283,90,165,39,39,0,0,39,2 (2ct 0st),0.236,1971,1984,RGD Willis ,ENG
284,40,71,38,38,0,0,38,3 (3ct 0st),0.535,1969,1981,CPS Chauhan ,INDIA
285,46,83,38,38,0,0,38,3 (3ct 0st),0.457,2008,2017,JP Duminy ,SA
286,58,104,38,38,0,0,38,2 (2ct 0st),0.365,2004,2016,G Gambhir ,INDIA
287,124,244,38,38,0,0,38,2 (2ct 0st),0.155,1993,2007,GD McGrath ,AUS
288,48,84,38,37,1,0,37,3 (3ct 0st),0.452,2009,2019,Mahmudullah ,BDESH
289,50,89,38,38,0,0,38,2 (2ct 0st),0.426,1985,1992,GR Marsh ,AUS
290,55,105,38,38,0,0,38,2 (2ct 0st),0.361,1946,1956,KR Miller ,AUS
291,82,145,38,38,0,0,38,3 (3ct 0st),0.262,1978,1993,JG Wright ,NZ
292,55,96,37,37,0,0,37,3 (3ct 0st),0.385,1958,1969,CG Borde ,INDIA
293,24,44,37,37,0,0,37,3 (3ct 0st),0.84,1920,1928,JM Gregory ,AUS
294,47,87,36,36,0,0,36,3 (3ct 0st),0.413,1992,2000,Aamer Sohail ,PAK
295,58,110,36,36,0,0,36,2 (2ct 0st),0.327,1964,1980,Asif Iqbal ,PAK
296,65,123,36,36,0,0,36,2 (2ct 0st),0.292,2011,2019,TA Boult ,NZ
297,25,49,36,36,0,0,36,3 (3ct 0st),0.7340000000000001,1983,1993,RA Harper ,WI
298,35,63,36,36,0,0,36,4 (4ct 0st),0.5710000000000001,1992,1998,AC Hudson ,SA
299,67,130,36,36,0,0,36,2 (2ct 0st),0.276,1992,2006,DR Martyn ,AUS
300,80,140,36,36,0,0,36,2 (2ct 0st),0.257,1981,1992,RJ Shastri ,INDIA
301,13,24,36,20,16,20,0,3 (3ct 0st),1.5,1906,1911,PW Sherwell ,SA
302,43,79,36,36,0,0,36,3 (3ct 0st),0.455,2003,2018,DS Smith ,WI
303,30,58,35,35,0,0,35,3 (3ct 0st),0.603,1961,1970,EJ Barlow ,SA
304,39,67,35,35,0,5,30,5 (5ct 0st),0.522,2008,2019,Imrul Kayes ,BDESH
305,44,83,35,35,0,0,35,3 (3ct 0st),0.421,2011,2019,UT Khawaja ,AUS
306,21,37,35,35,0,0,35,3 (3ct 0st),0.945,1973,1978,GRJ Roope ,ENG
307,39,75,35,34,1,6,28,2 (2ct 0st),0.466,2011,2018,JK Silva ,SL
308,53,100,35,35,0,0,35,2 (2ct 0st),0.35,1955,1975,FJ Titmus ,ENG
309,10,16,35,31,4,31,0,5 (5ct 0st),2.187,1979,1979,KJ Wright ,AUS
310,50,94,34,34,0,0,34,2 (2ct 0st),0.361,1968,1980,MG Burgess ,NZ
311,37,62,34,34,0,0,34,3 (3ct 0st),0.5479999999999999,1995,2005,SV Carlisle ,ZIM
312,23,43,34,34,0,0,34,3 (3ct 0st),0.79,2000,2002,SS Das ,INDIA
313,64,109,34,34,0,0,34,2 (2ct 0st),0.311,1978,1995,JE Emburey ,ENG
314,48,93,34,34,0,0,34,3 (3ct 0st),0.365,2012,2019,RA Jadeja ,INDIA
315,52,91,34,34,0,0,34,2 (2ct 0st),0.373,1984,1992,DM Jones ,AUS
316,49,92,34,34,0,0,34,2 (2ct 0st),0.369,1996,2004,L Klusener ,SA
317,60,113,34,34,0,0,34,2 (2ct 0st),0.3,1961,1971,GD McKenzie ,AUS
318,48,83,34,34,0,0,34,3 (3ct 0st),0.409,1978,1986,Mohsin Khan ,PAK
319,57,103,34,34,0,0,34,3 (3ct 0st),0.33,1984,1997,Rameez Raja ,PAK
320,52,96,34,34,0,0,34,2 (2ct 0st),0.354,1992,2000,JN Rhodes ,SA
321,9,15,34,33,1,33,0,6 (6ct 0st),2.266,1983,1988,SAR Silva ,SL
322,78,139,34,34,0,0,34,3 (3ct 0st),0.244,1969,1985,Zaheer Abbas ,PAK
323,108,193,33,33,0,0,33,2 (2ct 0st),0.17,1964,1982,G Boycott ,ENG
324,68,128,33,33,0,0,33,2 (2ct 0st),0.257,1992,2000,WJ Cronje ,SA
325,54,99,33,33,0,0,33,2 (2ct 0st),0.3329999999999999,1998,2006,AF Giles ,ENG
326,41,66,33,33,0,2,31,2 (2ct 0st),0.5,1985,1996,AP Gurusinha ,SL
327,51,92,33,33,0,0,33,2 (2ct 0st),0.358,1920,1935,EH Hendren ,ENG
328,49,93,33,33,0,0,33,3 (3ct 0st),0.354,1896,1912,C Hill ,AUS
329,40,70,33,33,0,0,33,3 (3ct 0st),0.471,2014,2019,JO Holder ,WI
330,30,55,33,33,0,0,33,3 (3ct 0st),0.6,1969,1977,HJ Howarth ,NZ
331,44,72,33,33,0,0,33,3 (3ct 0st),0.4579999999999999,1946,1959,MH Mankad ,INDIA
332,74,143,33,33,0,0,33,4 (4ct 0st),0.23,1993,2001,MJ Slater ,AUS
333,59,101,33,33,0,0,33,3 (3ct 0st),0.326,1948,1962,PR Umrigar ,INDIA
334,29,53,32,32,0,0,32,3 (3ct 0st),0.603,1967,1974,S Abid Ali ,INDIA
335,60,113,32,32,0,0,32,2 (2ct 0st),0.283,2014,2019,MM Ali ,ENG
336,61,118,32,32,0,0,32,2 (2ct 0st),0.271,1949,1959,TE Bailey ,ENG
337,52,99,32,32,0,0,32,2 (2ct 0st),0.3229999999999999,1928,1948,DG Bradman ,AUS
338,26,46,32,32,0,0,32,4 (4ct 0st),0.695,1924,1931,APF Chapman ,ENG
339,29,52,32,32,0,0,32,3 (3ct 0st),0.615,2016,2019,DM de Silva ,SL
340,45,83,32,32,0,0,32,3 (3ct 0st),0.385,2000,2005,WW Hinds ,WI
341,56,95,32,32,0,0,32,2 (2ct 0st),0.336,1985,1995,KR Rutherford ,NZ
342,23,37,32,19,13,19,0,3 (3ct 0st),0.8640000000000001,1912,1924,TA Ward ,SA
343,11,21,31,31,0,31,0,3 (3ct 0st),1.476,2008,2009,TR Ambrose ,ENG
344,41,73,31,31,0,0,31,3 (3ct 0st),0.424,1980,1990,JG Bracewell ,NZ
345,18,32,31,31,0,0,31,3 (3ct 0st),0.968,1946,1955,JT Ikin ,ENG
346,36,68,31,31,0,0,31,2 (2ct 0st),0.455,2010,2015,AN Petersen ,SA
347,47,88,31,31,0,0,31,2 (2ct 0st),0.352,1977,1984,DW Randall ,ENG
348,14,21,31,20,11,20,0,4 (4ct 0st),1.476,1948,1952,PK Sen ,INDIA
349,32,63,31,31,0,0,31,3 (3ct 0st),0.492,2013,2019,RG Sharma ,INDIA
350,33,61,31,31,0,1,30,3 (3ct 0st),0.508,1999,2010,MS Sinclair ,NZ
351,48,90,31,31,0,0,31,2 (2ct 0st),0.344,1899,1912,VT Trumper ,AUS
352,111,196,31,31,0,0,31,2 (2ct 0st),0.158,1994,2009,WPUJC Vaas ,SL
353,33,62,31,31,0,0,31,2 (2ct 0st),0.5,1978,1983,B Yardley ,AUS
354,40,76,31,31,0,0,31,2 (2ct 0st),0.407,2003,2012,Yuvraj Singh ,INDIA
355,43,78,30,30,0,0,30,2 (2ct 0st),0.384,1974,1985,BL Cairns ,NZ
356,48,87,30,30,0,0,30,3 (3ct 0st),0.344,1998,2008,D Ganga ,WI
357,11,18,30,29,1,29,0,4 (4ct 0st),1.666,2002,2003,RG Hart ,NZ
358,43,82,30,30,0,0,30,2 (2ct 0st),0.365,1938,1953,AL Hassett ,AUS
359,45,86,30,30,0,0,30,3 (3ct 0st),0.348,1946,1956,IWG Johnson ,AUS
360,18,31,30,23,7,21,2,5 (3ct 2st),0.967,1960,1967,BK Kunderan ,INDIA
361,67,127,30,30,0,0,30,2 (2ct 0st),0.236,1961,1971,WM Lawry ,AUS
362,38,73,30,30,0,0,30,2 (2ct 0st),0.41,1968,1980,AA Mallett ,AUS
363,14,23,30,22,8,22,0,4 (3ct 1st),1.304,1949,1954,FLH Mooney ,NZ
364,36,65,30,30,0,0,30,3 (3ct 0st),0.461,1973,1980,JM Parker ,NZ
365,40,75,30,30,0,0,30,2 (2ct 0st),0.4,1931,1939,H Verity ,ENG
366,40,70,30,30,0,0,30,2 (2ct 0st),0.428,1982,1994,KC Wessels ,AUS
367,45,85,29,29,0,0,29,3 (3ct 0st),0.341,1995,2004,PR Adams ,SA
368,37,65,29,29,0,0,29,2 (2ct 0st),0.446,1994,2003,JP Crawley ,ENG
369,62,116,29,29,0,0,29,2 (2ct 0st),0.25,1958,1968,ER Dexter ,ENG
370,44,83,29,29,0,0,29,3 (3ct 0st),0.349,1966,1972,BL D'Oliveira ,ENG
371,12,19,29,27,2,27,0,4 (4ct 0st),1.526,1995,1997,LK Germon ,NZ
372,47,86,29,29,0,0,29,2 (2ct 0st),0.337,1975,1985,GP Howarth ,NZ
373,18,26,29,27,2,20,7,4 (3ct 1st),1.115,2015,2019,Liton Das ,BDESH
374,35,64,29,29,0,0,29,2 (2ct 0st),0.4529999999999999,1894,1909,AC MacLaren ,ENG
375,38,63,29,29,0,0,29,3 (3ct 0st),0.46,2001,2018,H Masakadza ,ZIM
376,38,63,29,29,0,0,29,3 (3ct 0st),0.46,2013,2019,Mominul Haque ,BDESH
377,40,72,29,29,0,0,29,3 (3ct 0st),0.402,2011,2018,KOA Powell ,WI
378,48,92,29,29,0,0,29,2 (2ct 0st),0.315,2003,2012,JA Rudolph ,SA
379,23,42,29,29,0,0,29,3 (3ct 0st),0.69,1881,1893,A Shrewsbury snr ,ENG
380,52,99,29,29,0,0,29,2 (2ct 0st),0.292,2009,2015,IJL Trott ,ENG
381,132,244,29,29,0,0,29,2 (2ct 0st),0.118,1984,2001,CA Walsh ,WI
382,14,25,28,25,3,24,1,4 (4ct 0st),1.12,2011,2018,RW Chakabva ,ZIM
383,18,29,28,28,0,0,28,3 (3ct 0st),0.965,1928,1939,LN Constantine ,WI
384,28,50,28,28,0,0,28,2 (2ct 0st),0.56,1969,1975,MH Denness ,ENG
385,34,66,28,28,0,0,28,2 (2ct 0st),0.424,2013,2018,S Dhawan ,INDIA
386,16,30,28,28,0,0,28,3 (3ct 0st),0.933,2016,2019,PSP Handscomb ,AUS
387,88,158,28,28,0,0,28,3 (3ct 0st),0.177,1971,1992,Imran Khan ,PAK
388,18,36,28,28,0,0,28,3 (3ct 0st),0.777,1886,1896,GA Lohmann ,ENG
389,41,74,28,28,0,0,28,2 (2ct 0st),0.3779999999999999,1969,1981,Sadiq Mohammad ,PAK
390,71,127,28,28,0,0,28,2 (2ct 0st),0.22,2000,2016,MN Samuels ,WI
391,56,109,28,28,0,0,28,2 (2ct 0st),0.256,2011,2019,MA Starc ,AUS
392,70,134,28,28,0,0,28,2 (2ct 0st),0.208,1951,1965,JB Statham ,ENG
393,41,75,27,27,0,0,27,2 (2ct 0st),0.36,1981,1991,TM Alderman ,AUS
394,34,63,27,27,0,0,27,3 (3ct 0st),0.428,1894,1905,J Darling ,AUS
395,38,72,27,27,0,0,27,2 (2ct 0st),0.375,1999,2007,HH Dippenaar ,SA
396,71,141,27,27,0,0,27,1 (1ct 0st),0.191,1996,2006,JN Gillespie ,AUS
397,41,64,27,27,0,0,27,3 (3ct 0st),0.421,1988,1996,MJ Greatbatch ,NZ
398,31,58,27,27,0,0,27,3 (3ct 0st),0.465,2000,2008,W Jaffer ,INDIA
399,73,141,27,27,0,0,27,4 (4ct 0st),0.191,2007,2015,MG Johnson ,AUS
400,12,20,27,18,9,18,0,4 (2ct 2st),1.35,1951,1960,PG Joshi ,INDIA
401,32,53,27,27,0,0,27,2 (2ct 0st),0.509,2009,2012,NT Paranavitana ,SL
402,46,84,27,27,0,0,27,2 (2ct 0st),0.321,1961,1975,MAK Pataudi ,INDIA
403,18,35,27,19,8,14,5,3 (3ct 0st),0.7709999999999999,2015,2019,MDKJ Perera ,SL
404,28,45,27,27,0,3,24,2 (2ct 0st),0.6,2004,2018,BRM Taylor ,ZIM
405,25,43,27,27,0,0,27,2 (2ct 0st),0.627,1927,1935,CL Vincent ,SA
406,31,53,27,27,0,0,27,2 (2ct 0st),0.509,1994,2002,SC Williams ,WI
407,67,121,26,26,0,0,26,1 (1ct 0st),0.214,1966,1979,BS Bedi ,INDIA
408,51,93,26,26,0,0,26,2 (2ct 0st),0.2789999999999999,1946,1955,AV Bedser ,ENG
409,59,104,26,26,0,0,26,2 (2ct 0st),0.25,2011,2019,KC Brathwaite ,WI
410,22,42,26,26,0,0,26,3 (3ct 0st),0.619,1928,1934,DR Jardine ,ENG
411,17,31,26,26,0,0,26,4 (4ct 0st),0.838,1995,2001,NV Knight ,ENG
412,61,117,26,26,0,0,26,2 (2ct 0st),0.222,1946,1960,RR Lindwall ,AUS
413,37,68,26,25,1,0,25,3 (3ct 0st),0.382,1987,1996,SV Manjrekar ,INDIA
414,42,79,26,26,0,0,26,3 (3ct 0st),0.3289999999999999,1898,1909,MA Noble ,AUS
415,38,68,26,26,0,0,26,2 (2ct 0st),0.382,2000,2004,MH Richardson ,NZ
416,55,98,26,26,0,0,26,3 (3ct 0st),0.265,1969,1984,Sarfraz Nawaz ,PAK
417,26,48,26,26,0,0,26,2 (2ct 0st),0.541,1988,1997,PV Simmons ,WI
418,93,175,26,26,0,0,26,2 (2ct 0st),0.148,2004,2019,DW Steyn ,SA
419,26,47,26,26,0,0,26,3 (3ct 0st),0.5529999999999999,1960,1969,RF Surti ,INDIA
420,11,19,26,24,2,24,0,4 (4ct 0st),1.368,1959,1960,R Swetman ,ENG
421,37,67,26,26,0,0,26,2 (2ct 0st),0.3879999999999999,1949,1960,HJ Tayfield ,SA
422,9,15,25,22,3,22,0,3 (3ct 0st),1.666,1984,1985,Anil Dalpat ,PAK
423,58,102,25,25,0,0,25,2 (2ct 0st),0.245,1964,1979,BS Chandrasekhar ,INDIA
424,23,42,25,25,0,0,25,3 (3ct 0st),0.595,2006,2014,PG Fulton ,NZ
425,58,107,25,25,0,0,25,2 (2ct 0st),0.233,1890,1912,SE Gregory ,AUS
426,30,56,25,25,0,0,25,3 (3ct 0st),0.446,1974,1981,M Hendrick ,ENG
427,39,62,25,25,0,0,25,2 (2ct 0st),0.4029999999999999,1987,1995,AH Jones ,NZ
428,32,58,25,25,0,0,25,2 (2ct 0st),0.431,1990,1996,CC Lewis ,ENG
429,81,153,25,25,0,0,25,2 (2ct 0st),0.163,1978,1991,MD Marshall ,WI
430,61,91,25,25,0,0,25,2 (2ct 0st),0.2739999999999999,2001,2013,Mohammad Ashraful ,BDESH
431,86,160,25,25,0,0,25,2 (2ct 0st),0.156,2006,2018,M Morkel ,SA
432,101,192,25,25,0,0,25,1 (1ct 0st),0.13,1998,2009,M Ntini ,SA
433,14,18,25,25,0,25,0,4 (4ct 0st),1.388,1955,1966,EC Petrie ,NZ
434,50,90,24,24,0,0,24,2 (2ct 0st),0.266,1966,1977,DL Amiss ,ENG
435,70,134,24,24,0,0,24,2 (2ct 0st),0.179,2011,2019,R Ashwin ,INDIA
436,28,47,24,24,0,0,24,5 (5ct 0st),0.51,2014,2019,J Blackwood ,WI
437,22,44,24,24,0,0,24,3 (3ct 0st),0.545,1949,1976,DB Close ,ENG
438,18,35,24,24,0,0,24,3 (3ct 0st),0.685,2011,2013,EJM Cowan ,AUS
439,11,14,24,19,5,19,0,5 (5ct 0st),1.714,1993,1994,PB Dassanayake ,SL
440,6,11,24,22,2,22,0,4 (4ct 0st),2.181,1986,1988,GC Dyer ,AUS
441,31,55,24,24,0,0,24,3 (3ct 0st),0.436,1881,1896,G Giffen ,AUS
442,93,172,24,24,0,0,24,2 (2ct 0st),0.139,1999,2018,HMRKB Herath ,SL
443,67,125,24,24,0,0,24,2 (2ct 0st),0.192,2000,2008,MJ Hoggard ,ENG
444,26,47,24,24,0,0,24,3 (3ct 0st),0.51,1910,1928,C Kelleway ,AUS
445,18,32,24,22,2,1,21,2 (2ct 0st),0.75,1996,2000,Mohammad Wasim ,PAK
446,19,37,24,24,0,0,24,5 (5ct 0st),0.648,1924,1936,VY Richardson ,AUS
447,6,11,24,16,8,16,0,4 (1ct 3st),2.181,1948,1950,RA Saggers ,AUS
448,56,97,24,24,0,0,24,2 (2ct 0st),0.247,2007,2019,Shakib Al Hasan ,BDESH
449,26,47,24,24,0,0,24,2 (2ct 0st),0.51,1906,1923,SJ Snooke ,SA
450,31,58,24,24,0,0,24,3 (3ct 0st),0.413,2005,2017,WU Tharanga ,SL
451,9,17,24,23,1,23,0,4 (4ct 0st),1.411,2012,2012,CFK van Wyk ,NZ
452,42,78,23,23,0,0,23,2 (2ct 0st),0.294,1955,1966,PJP Burge ,AUS
453,11,14,23,21,2,21,0,4 (4ct 0st),1.642,1983,1988,RG de Alwis ,SL
454,39,71,23,23,0,0,23,3 (3ct 0st),0.3229999999999999,1961,1972,GT Dowling ,NZ
455,31,54,23,23,0,0,23,3 (3ct 0st),0.425,1969,1976,BF Hastings ,NZ
456,53,97,23,23,0,0,23,2 (2ct 0st),0.237,1985,1994,MG Hughes ,AUS
457,76,151,23,23,0,0,23,2 (2ct 0st),0.152,1999,2008,B Lee ,AUS
458,70,133,23,23,0,0,23,2 (2ct 0st),0.172,1971,1984,DK Lillee ,AUS
459,40,72,23,23,0,0,23,2 (2ct 0st),0.319,1951,1964,RA McLean ,SA
460,38,72,23,23,0,0,23,2 (2ct 0st),0.319,2011,2019,SE Marsh ,AUS
461,52,94,23,23,0,0,23,2 (2ct 0st),0.244,1990,2003,Mushtaq Ahmed ,PAK
462,18,33,23,23,0,0,23,2 (2ct 0st),0.696,2010,2015,SK Raina ,INDIA
463,29,51,23,23,0,0,23,3 (3ct 0st),0.45,2002,2007,SB Styris ,NZ
464,54,96,23,23,0,0,23,3 (3ct 0st),0.239,1924,1935,H Sutcliffe ,ENG
465,39,69,23,23,0,0,23,2 (2ct 0st),0.3329999999999999,1976,1984,GN Yallop ,AUS
466,33,62,22,22,0,0,22,2 (2ct 0st),0.354,1988,1995,KLT Arthurton ,WI
467,8,14,22,17,5,17,0,4 (2ct 2st),1.571,1982,1987,Ashraf Ali ,PAK
468,23,46,22,22,0,0,22,3 (3ct 0st),0.478,2014,2017,GS Ballance ,ENG
469,11,16,22,17,5,16,1,3 (3ct 0st),1.375,1930,1939,IM Barrow ,WI
470,22,40,22,22,0,0,22,2 (2ct 0st),0.55,1931,1953,FR Brown ,ENG
471,20,38,22,22,0,0,22,2 (2ct 0st),0.578,2014,2019,JA Burns ,AUS
472,26,46,22,22,0,0,22,3 (3ct 0st),0.478,2001,2010,Faisal Iqbal ,PAK
473,27,51,22,22,0,0,22,2 (2ct 0st),0.431,1948,1957,JDC Goddard ,WI
474,50,70,22,22,0,0,22,2 (2ct 0st),0.314,2000,2008,Habibul Bashar ,BDESH
475,60,114,22,22,0,0,22,2 (2ct 0st),0.192,1975,1987,MA Holding ,WI
476,55,99,22,22,0,0,22,1 (1ct 0st),0.222,1997,2005,CD McMillan ,NZ
477,21,36,22,22,0,0,22,4 (4ct 0st),0.611,1955,1962,W Mathias ,PAK
478,41,73,22,22,0,0,22,2 (2ct 0st),0.301,1955,1968,RG Nadkarni ,INDIA
479,46,84,22,22,0,0,22,2 (2ct 0st),0.261,1972,1981,CM Old ,ENG
480,41,76,22,22,0,0,22,2 (2ct 0st),0.289,2015,2019,K Rabada ,SA
481,45,79,22,22,0,0,22,2 (2ct 0st),0.278,1983,1995,Shoaib Mohammad ,PAK
482,67,122,22,22,0,0,22,2 (2ct 0st),0.18,1991,2002,J Srinath ,INDIA
483,26,52,22,22,0,0,22,3 (3ct 0st),0.423,2004,2008,A Symonds ,AUS
484,28,49,21,21,0,0,21,2 (2ct 0st),0.428,1879,1893,AC Bannerman ,AUS
485,28,49,21,21,0,0,21,2 (2ct 0st),0.428,1960,1968,RW Barber ,ENG
486,11,17,21,19,2,18,1,4 (4ct 0st),1.235,1986,1994,TE Blain ,NZ
487,62,106,21,21,0,0,21,2 (2ct 0st),0.198,1993,2003,AR Caddick ,ENG
488,22,44,21,19,2,1,18,3 (1ct 2st),0.477,1948,1954,RJ Christiani ,WI
489,27,50,21,21,0,0,21,2 (2ct 0st),0.42,1964,1968,RM Cowper ,AUS
490,10,17,21,19,2,19,0,4 (4ct 0st),1.235,1969,1973,TM Findlay ,WI
491,18,35,21,21,0,0,21,4 (4ct 0st),0.6,1951,1955,GB Hole ,AUS
492,19,34,21,21,0,0,21,3 (3ct 0st),0.617,1894,1902,E Jones ,AUS
493,25,47,21,21,0,0,21,2 (2ct 0st),0.446,1975,1980,RB McCosker ,AUS
494,55,96,21,19,2,2,17,2 (2ct 0st),0.218,1951,1965,VL Manjrekar ,INDIA
495,13,25,21,21,0,0,21,2 (2ct 0st),0.84,1968,1971,BAG Murray ,NZ
496,31,58,21,21,0,0,21,2 (2ct 0st),0.362,2016,2019,HM Nicholls ,NZ
497,29,54,21,21,0,1,20,2 (2ct 0st),0.3879999999999999,1960,1969,SM Nurse ,WI
498,42,82,21,21,0,0,21,2 (2ct 0st),0.256,1958,1965,NCL O'Neill ,AUS
499,31,50,21,21,0,0,21,2 (2ct 0st),0.42,1947,1959,DG Phadkar ,INDIA
500,29,55,21,21,0,0,21,2 (2ct 0st),0.381,1924,1934,WH Ponsford ,AUS
501,23,44,21,21,0,0,21,3 (3ct 0st),0.477,2016,2019,JA Raval ,NZ
502,8,15,21,20,1,20,0,5 (5ct 0st),1.4,1986,1988,CJ Richards ,ENG
503,96,177,21,21,0,0,21,2 (2ct 0st),0.118,2007,2019,I Sharma ,INDIA
504,15,25,21,21,0,0,21,4 (4ct 0st),0.84,2015,2019,Soumya Sarkar ,BDESH
505,19,38,21,21,0,0,21,2 (2ct 0st),0.552,1995,2000,CM Spearman ,NZ
506,24,44,21,21,0,0,21,2 (2ct 0st),0.477,1888,1898,GHS Trott ,AUS
507,25,47,20,20,0,0,20,2 (2ct 0st),0.425,1930,1948,GOB Allen ,ENG
508,19,35,20,20,0,0,20,4 (4ct 0st),0.5710000000000001,1953,1956,RG Archer ,AUS
509,36,64,20,20,0,0,20,3 (3ct 0st),0.312,2011,2018,D Bishoo ,WI
510,25,44,20,20,0,0,20,3 (3ct 0st),0.4539999999999999,1906,1924,GA Faulkner ,SA
511,47,87,20,20,0,0,20,2 (2ct 0st),0.2289999999999999,1959,1977,Intikhab Alam ,PAK
512,7,11,20,19,1,19,0,4 (3ct 1st),1.818,1954,1956,LV Maddocks ,AUS
513,15,26,20,20,0,0,20,2 (2ct 0st),0.769,2005,2008,RS Morton ,WI
514,39,69,20,20,0,0,20,2 (2ct 0st),0.289,1984,1995,M Prabhakar ,INDIA
515,33,57,20,20,0,0,20,3 (3ct 0st),0.35,1952,1960,GS Ramchand ,INDIA
516,6,12,20,20,0,20,0,3 (3ct 0st),1.666,1962,1963,AC Smith ,ENG
517,11,20,20,17,3,16,1,3 (3ct 0st),1.0,1911,1913,EJ Smith ,ENG
518,32,63,20,20,0,0,20,2 (2ct 0st),0.317,1939,1955,JB Stollmeyer ,WI
519,42,61,20,20,0,0,20,2 (2ct 0st),0.327,1947,1965,B Sutcliffe ,NZ
520,31,56,20,20,0,0,20,1 (1ct 0st),0.357,1980,1989,CJ Tavare ,ENG
521,35,65,20,20,0,0,20,2 (2ct 0st),0.307,2011,2019,HDRL Thirimanne ,SL
522,51,94,20,20,0,0,20,1 (1ct 0st),0.212,1972,1985,JR Thomson ,AUS
523,15,28,20,20,0,0,20,4 (4ct 0st),0.7140000000000001,1906,1911,AEE Vogler ,SA
524,57,98,20,20,0,0,20,2 (2ct 0st),0.204,1973,1985,Wasim Raja ,PAK
525,25,47,20,20,0,0,20,2 (2ct 0st),0.425,2003,2010,Yasir Hameed ,PAK
526,25,44,19,19,0,0,19,2 (2ct 0st),0.431,1986,1997,Asif Mujtaba ,PAK
527,25,46,19,19,0,0,19,2 (2ct 0st),0.413,2016,2019,Babar Azam ,PAK
528,21,40,19,19,0,0,19,3 (3ct 0st),0.475,1880,1890,W Barnes ,ENG
529,18,33,19,19,0,0,19,2 (2ct 0st),0.575,1998,2008,MD Bell ,NZ
530,35,67,19,19,0,0,19,2 (2ct 0st),0.283,1896,1909,TW Hayward ,ENG
531,92,173,19,19,0,0,19,2 (2ct 0st),0.109,2000,2014,Z Khan ,INDIA
532,71,126,19,19,0,0,19,2 (2ct 0st),0.15,1984,1996,CJ McDermott ,AUS
533,22,39,19,19,0,0,19,2 (2ct 0st),0.487,2016,2019,Mehidy Hasan Miraz ,BDESH
534,6,12,19,17,2,17,0,5 (4ct 1st),1.5830000000000002,2013,2014,R Mutumbami ,ZIM
535,41,75,19,19,0,0,19,2 (2ct 0st),0.253,2014,2019,MDK Perera ,SL
536,32,57,19,19,0,0,19,3 (3ct 0st),0.3329999999999999,1965,1973,V Pollard ,NZ
537,24,38,19,19,0,0,19,2 (2ct 0st),0.5,2005,2013,Shahriar Nafees ,BDESH
538,67,128,19,19,0,0,19,2 (2ct 0st),0.148,2008,2019,PM Siddle ,AUS
539,42,69,19,19,0,0,19,2 (2ct 0st),0.275,1912,1932,HW Taylor ,SA
540,25,47,19,19,0,0,19,3 (3ct 0st),0.4039999999999999,1877,1890,G Ulyett ,ENG
541,23,41,19,19,0,0,19,3 (3ct 0st),0.4629999999999999,2001,2007,L Vincent ,NZ
542,46,81,19,19,0,0,19,3 (3ct 0st),0.2339999999999999,1993,2002,GJ Whittall ,ZIM
543,38,72,19,19,0,0,19,2 (2ct 0st),0.263,2014,2019,Yasir Shah ,PAK
544,10,16,19,18,1,18,0,3 (3ct 0st),1.187,1986,1987,TJ Zoehrer ,AUS
545,5,10,18,15,3,15,0,3 (3ct 0st),1.8,1962,1966,DW Allan ,WI
546,98,182,18,18,0,0,18,1 (1ct 0st),0.098,1988,2000,CEL Ambrose ,WI
547,43,80,18,18,0,0,18,2 (2ct 0st),0.225,2000,2006,N Boje ,SA
548,24,45,18,18,0,0,18,2 (2ct 0st),0.4,1951,1959,JW Burke ,AUS
549,31,54,18,18,0,0,18,2 (2ct 0st),0.3329999999999999,1955,1962,NJ Contractor ,INDIA
550,37,65,18,18,0,0,18,2 (2ct 0st),0.276,1995,2002,DG Cork ,ENG
551,61,115,18,18,0,0,18,1 (1ct 0st),0.156,2000,2010,Danish Kaneria ,PAK
552,72,134,18,18,0,0,18,2 (2ct 0st),0.134,1992,2002,AA Donald ,SA
553,7,13,18,17,1,17,0,5 (5ct 0st),1.384,2001,2002,JS Foster ,ENG
554,60,112,18,18,0,0,18,1 (1ct 0st),0.16,1976,1987,HA Gomes ,WI
555,29,58,18,18,0,0,18,3 (3ct 0st),0.31,1939,1954,GE Gomez ,WI
556,51,96,18,18,0,0,18,2 (2ct 0st),0.187,2014,2019,JR Hazlewood ,AUS
557,24,44,18,18,0,0,18,2 (2ct 0st),0.409,1897,1909,GH Hirst ,ENG
558,24,42,18,18,0,0,18,2 (2ct 0st),0.428,1966,1977,DAJ Holford ,WI
559,19,32,18,18,0,0,18,2 (2ct 0st),0.562,2006,2009,JM How ,NZ
560,11,19,18,9,9,8,1,3 (3ct 0st),0.947,1885,1895,AH Jarvis ,AUS
561,34,63,18,18,0,0,18,3 (3ct 0st),0.285,1951,1962,DJ McGlew ,SA
562,4,8,18,18,0,18,0,5 (5ct 0st),2.25,1978,1979,JA Maclean ,AUS
563,49,88,18,18,0,0,18,2 (2ct 0st),0.204,1962,1978,EAS Prasanna ,INDIA
564,19,36,18,18,0,0,18,2 (2ct 0st),0.5,1999,2001,S Ramesh ,INDIA
565,55,101,18,18,0,0,18,2 (2ct 0st),0.178,1990,2001,Saeed Anwar ,PAK
566,20,36,18,18,0,0,18,2 (2ct 0st),0.5,1906,1912,RO Schwarz ,SA
567,35,67,18,18,0,0,18,2 (2ct 0st),0.268,2001,2015,Shoaib Malik ,PAK
568,87,158,18,18,0,0,18,3 (3ct 0st),0.113,1989,2003,Waqar Younis ,PAK
569,40,65,18,18,0,0,18,2 (2ct 0st),0.276,1991,2001,GP Wickramasinghe ,SL
570,19,34,17,17,0,0,17,3 (3ct 0st),0.5,1978,1982,SFAF Bacchus ,WI
571,39,70,17,17,0,0,17,2 (2ct 0st),0.242,2014,2019,T Bavuma ,SA
572,5,10,17,14,3,14,0,3 (3ct 0st),1.7,1953,1956,AP Binns ,WI
573,29,54,17,17,0,0,17,2 (2ct 0st),0.314,1961,1966,BC Booth ,AUS
574,14,25,17,17,0,0,17,4 (4ct 0st),0.68,2011,2013,DG Brownlie ,NZ
575,29,55,17,17,0,0,17,2 (2ct 0st),0.309,1963,1971,AN Connolly ,AUS
576,26,47,17,17,0,0,17,2 (2ct 0st),0.361,1896,1912,CB Fry ,ENG
577,29,56,17,17,0,0,17,2 (2ct 0st),0.303,1967,1972,JW Gleeson ,AUS
578,37,71,17,17,0,0,17,2 (2ct 0st),0.239,1925,1936,CV Grimmett ,AUS
579,61,110,17,17,0,0,17,2 (2ct 0st),0.154,1908,1930,JB Hobbs ,ENG
580,35,65,17,17,0,0,17,3 (3ct 0st),0.261,1997,2003,MJ Horne ,NZ
581,22,40,17,17,0,0,17,3 (3ct 0st),0.425,1992,1997,DL Houghton ,ZIM
582,39,72,17,17,0,0,17,1 (1ct 0st),0.236,1959,1971,ML Jaisimha ,INDIA
583,17,32,17,17,0,0,17,4 (4ct 0st),0.531,2016,2019,KK Jennings ,ENG
584,59,109,17,17,0,0,17,1 (1ct 0st),0.155,2010,2019,RAS Lakmal ,SL
585,35,64,17,17,0,0,17,1 (1ct 0st),0.265,1907,1926,CG Macartney ,AUS
586,8,15,17,14,3,14,0,3 (3ct 0st),1.133,1890,1893,G MacGregor ,ENG
587,33,56,17,17,0,0,17,2 (2ct 0st),0.303,1983,1993,GRJ Matthews ,AUS
588,34,62,17,17,0,0,17,2 (2ct 0st),0.2739999999999999,1976,1984,G Miller ,ENG
589,21,40,17,17,0,0,17,2 (2ct 0st),0.425,2009,2010,MJ North ,AUS
590,21,37,17,17,0,0,17,3 (3ct 0st),0.4589999999999999,1974,1977,BP Patel ,INDIA
591,20,38,17,17,0,0,17,2 (2ct 0st),0.447,1884,1896,R Peel ,ENG
592,61,114,17,17,0,0,17,1 (1ct 0st),0.149,2011,2019,VD Philander ,SA
593,23,44,17,17,0,0,17,2 (2ct 0st),0.386,1963,1970,RG Pollock ,SA
594,30,55,17,17,0,0,17,2 (2ct 0st),0.309,1972,1980,LG Rowe ,WI
595,20,36,17,17,0,0,17,3 (3ct 0st),0.472,1920,1929,J Ryder ,AUS
596,12,24,17,17,0,0,17,2 (2ct 0st),0.708,1963,1969,PJ Sharpe ,ENG
597,31,60,17,17,0,0,17,1 (1ct 0st),0.283,1967,1974,AP Sheahan ,AUS
598,65,110,17,17,0,0,17,2 (2ct 0st),0.154,1993,2005,HH Streak ,ZIM
599,11,18,17,15,2,15,0,3 (3ct 0st),0.944,1938,1950,WW Wade ,SA
600,8,15,17,16,1,16,0,4 (4ct 0st),1.133,1964,1968,JT Ward ,NZ
601,15,26,17,17,0,0,17,3 (3ct 0st),0.653,1948,1952,AJ Watkins ,ENG
602,14,26,16,15,1,4,11,4 (4ct 0st),0.615,1987,1994,Aamer Malik ,PAK
603,10,19,16,16,0,0,16,3 (3ct 0st),0.8420000000000001,2017,2019,CT Bancroft ,AUS
604,19,38,16,16,0,0,16,2 (2ct 0st),0.421,1997,2003,AJ Bichel ,AUS
605,17,29,16,16,0,0,16,3 (3ct 0st),0.551,1880,1888,GJ Bonnor ,AUS
606,18,33,16,16,0,0,16,3 (3ct 0st),0.484,2005,2013,N Deonarine ,WI
607,38,69,16,16,0,0,16,2 (2ct 0st),0.231,1997,2004,M Dillon ,WI
608,32,53,16,16,0,0,16,2 (2ct 0st),0.301,1992,2000,SB Doull ,NZ
609,29,45,16,16,0,0,16,2 (2ct 0st),0.355,2001,2005,DD Ebrahim ,ZIM
610,45,79,16,16,0,0,16,2 (2ct 0st),0.2019999999999999,2012,2019,ST Gabriel ,WI
611,39,69,16,16,0,0,16,2 (2ct 0st),0.231,1974,1981,KD Ghavri ,INDIA
612,28,52,16,16,0,0,16,2 (2ct 0st),0.307,1960,1969,CC Griffith ,WI
613,8,15,16,13,3,13,0,3 (3ct 0st),1.0659999999999998,1951,1956,SC Guillen ,NZ
614,21,39,16,16,0,0,16,2 (2ct 0st),0.41,2002,2007,AJ Hall ,SA
615,23,41,16,16,0,0,16,2 (2ct 0st),0.39,1977,1983,Haroon Rasheed ,PAK
616,37,69,16,16,0,0,16,2 (2ct 0st),0.231,2007,2011,PL Harris ,SA
617,40,74,16,16,0,0,16,1 (1ct 0st),0.216,1969,1979,VA Holder ,WI
618,44,85,16,16,0,0,16,2 (2ct 0st),0.188,1958,1967,CC Hunte ,WI
619,14,27,16,16,0,0,16,3 (3ct 0st),0.5920000000000001,1894,1899,FA Iredale ,AUS
620,11,16,16,11,5,11,0,2 (2ct 0st),1.0,1930,1933,KC James ,NZ
621,4,7,16,16,0,16,0,5 (5ct 0st),2.285,1993,1994,WR James ,ZIM
622,40,79,16,16,0,0,16,2 (2ct 0st),0.2019999999999999,1947,1955,WA Johnston ,AUS
623,26,45,16,16,0,0,16,2 (2ct 0st),0.355,1946,1958,AH Kardar ,INDIA
624,38,75,16,16,0,0,16,2 (2ct 0st),0.213,1996,2006,MS Kasprowicz ,AUS
625,21,37,16,16,0,0,16,2 (2ct 0st),0.432,1979,1982,BM Laird ,AUS
626,44,87,16,16,0,0,16,2 (2ct 0st),0.183,1998,2008,SCG MacGill ,AUS
627,37,71,16,16,0,0,16,2 (2ct 0st),0.225,1956,1963,KD Mackay ,AUS
628,32,62,16,16,0,0,16,2 (2ct 0st),0.258,2014,2019,MR Marsh ,AUS
629,36,69,16,16,0,0,16,2 (2ct 0st),0.231,2001,2008,A Nel ,SA
630,5,9,16,14,2,11,3,4 (4ct 0st),1.777,1986,1992,CS Pandit ,INDIA
631,18,35,16,16,0,0,16,2 (2ct 0st),0.457,1882,1893,WW Read ,ENG
632,43,72,16,16,0,0,16,2 (2ct 0st),0.222,1951,1960,P Roy ,INDIA
633,14,27,16,16,0,0,16,3 (3ct 0st),0.5920000000000001,2003,2014,V Sibanda ,ZIM
634,49,93,16,16,0,0,16,2 (2ct 0st),0.172,1965,1976,JA Snow ,ENG
635,31,59,16,16,0,0,16,1 (1ct 0st),0.271,1899,1909,JT Tyldesley ,ENG
636,40,74,16,16,0,0,16,2 (2ct 0st),0.216,1927,1937,RES Wyatt ,ENG
637,45,88,16,16,0,0,16,2 (2ct 0st),0.181,2011,2019,UT Yadav ,INDIA
638,37,60,16,16,0,0,16,2 (2ct 0st),0.266,1979,1983,Yashpal Sharma ,INDIA
639,67,117,15,15,0,0,15,2 (2ct 0st),0.128,1977,1990,Abdul Qadir ,PAK
640,46,85,15,15,0,0,15,2 (2ct 0st),0.176,1999,2006,Abdul Razzaq ,PAK
641,44,83,15,15,0,0,15,2 (2ct 0st),0.18,1958,1969,BF Butcher ,WI
642,14,26,15,15,0,0,15,3 (3ct 0st),0.5760000000000001,1934,1938,AG Chipperfield ,AUS
643,10,19,15,15,0,0,15,3 (3ct 0st),0.789,2003,2004,A Chopra ,INDIA
644,5,9,15,13,2,13,0,4 (4ct 0st),1.666,1995,1995,CI Dunusinghe ,SL
645,17,32,15,15,0,0,15,2 (2ct 0st),0.4679999999999999,2011,2014,KA Edwards ,WI
646,15,26,15,15,0,0,15,4 (4ct 0st),0.5760000000000001,2011,2017,CR Ervine ,ZIM
647,10,19,15,15,0,0,15,3 (3ct 0st),0.789,1929,1931,AG Fairfax ,AUS
648,40,66,15,15,0,0,15,2 (2ct 0st),0.2269999999999999,1974,1985,AD Gaekwad ,INDIA
649,15,30,15,15,0,0,15,2 (2ct 0st),0.5,1907,1930,G Gunn ,ENG
650,26,48,15,15,0,0,15,2 (2ct 0st),0.312,2009,2013,PJ Hughes ,AUS
651,12,23,15,15,0,0,15,2 (2ct 0st),0.652,1899,1909,AO Jones ,ENG
652,21,38,15,15,0,0,15,4 (4ct 0st),0.3939999999999999,1926,1933,H Larwood ,ENG
653,39,66,15,15,0,0,15,1 (1ct 0st),0.2269999999999999,1974,1986,S Madan Lal ,INDIA
654,13,24,15,15,0,0,15,2 (2ct 0st),0.625,1951,1955,PNF Mansell ,SA
655,20,39,15,15,0,0,15,3 (3ct 0st),0.384,2017,2019,AK Markram ,SA
656,6,12,15,13,2,13,0,4 (2ct 2st),1.25,1961,1962,G Millman ,ENG
657,46,90,15,15,0,0,15,2 (2ct 0st),0.166,1946,1955,AR Morris ,AUS
658,13,24,15,15,0,0,15,3 (3ct 0st),0.625,2002,2015,J Mubarak ,SL
659,19,36,15,14,1,3,11,3 (3ct 0st),0.416,1877,1892,WL Murdoch ,AUS
660,24,47,15,15,0,0,15,2 (2ct 0st),0.319,1971,1977,KJ O'Keeffe ,AUS
661,33,60,15,15,0,0,15,2 (2ct 0st),0.25,2002,2009,JDP Oram ,NZ
662,37,62,15,15,0,0,15,2 (2ct 0st),0.241,1987,1997,DN Patel ,NZ
663,25,46,15,15,0,0,15,3 (3ct 0st),0.326,1968,1985,PI Pocock ,ENG
664,6,11,15,15,0,15,0,4 (4ct 0st),1.3630000000000002,1999,2000,MSK Prasad ,INDIA
665,26,42,15,15,0,0,15,2 (2ct 0st),0.357,1983,1986,Qasim Umar ,PAK
666,24,37,15,15,0,1,14,3 (3ct 0st),0.405,2003,2008,Rajin Saleh ,BDESH
667,35,68,15,15,0,0,15,1 (1ct 0st),0.22,1992,1998,PR Reiffel ,AUS
668,25,49,15,15,0,0,15,3 (3ct 0st),0.306,2008,2015,CJL Rogers ,AUS
669,49,87,15,15,0,0,15,2 (2ct 0st),0.172,1995,2004,Saqlain Mushtaq ,PAK
670,24,44,15,15,0,0,15,3 (3ct 0st),0.34,1994,2001,PA Strang ,ZIM
671,27,47,15,15,0,0,15,2 (2ct 0st),0.319,2014,2019,Taijul Islam ,BDESH
672,26,46,15,15,0,0,15,2 (2ct 0st),0.326,2000,2010,DR Tuffey ,NZ
673,14,27,15,15,0,0,15,4 (4ct 0st),0.555,1975,1977,A Turner ,AUS
674,27,51,15,15,0,0,15,2 (2ct 0st),0.294,1930,1947,W Voce ,ENG
675,20,37,15,15,0,0,15,3 (3ct 0st),0.405,2015,2016,AC Voges ,AUS
676,27,45,15,15,0,0,15,2 (2ct 0st),0.3329999999999999,1995,2005,CB Wishart ,ZIM
677,21,37,14,14,0,0,14,3 (3ct 0st),0.3779999999999999,1997,2001,Azhar Mahmood ,PAK
678,17,31,14,14,0,0,14,2 (2ct 0st),0.451,1881,1887,RG Barlow ,ENG
679,13,25,14,14,0,0,14,3 (3ct 0st),0.56,1938,1948,SG Barnes ,AUS
680,20,39,14,14,0,0,14,2 (2ct 0st),0.358,1933,1948,CJ Barnett ,ENG
681,26,45,14,14,0,0,14,2 (2ct 0st),0.311,2008,2015,SJ Benn ,WI
682,30,54,14,14,0,0,14,2 (2ct 0st),0.259,1978,1989,SL Boock ,NZ
683,22,41,14,14,0,0,14,2 (2ct 0st),0.341,1934,1948,WA Brown ,AUS
684,62,110,14,14,0,0,14,2 (2ct 0st),0.127,1989,2004,CL Cairns ,NZ
685,32,56,14,14,0,0,14,3 (3ct 0st),0.25,2016,2019,RL Chase ,WI
686,18,34,14,14,0,0,14,2 (2ct 0st),0.411,1975,1978,GJ Cosier ,AUS
687,15,29,14,14,0,0,14,2 (2ct 0st),0.482,2014,2016,MD Craig ,NZ
688,44,78,14,14,0,0,14,2 (2ct 0st),0.179,1986,1995,PAJ DeFreitas ,ENG
689,21,41,14,14,0,0,14,2 (2ct 0st),0.341,2016,2019,C de Grandhomme ,NZ
690,31,53,14,14,0,0,14,3 (3ct 0st),0.264,1993,2004,HDPK Dharmasena ,SL
691,6,11,14,12,2,12,0,3 (3ct 0st),1.272,2001,2001,SS Dighe ,INDIA
692,22,41,14,14,0,0,14,2 (2ct 0st),0.341,1902,1905,RA Duff ,AUS
693,29,53,14,14,0,0,14,3 (3ct 0st),0.264,1960,1973,SA Durani ,INDIA
694,39,72,14,14,0,3,11,3 (3ct 0st),0.1939999999999999,1978,1986,BA Edgar ,NZ
695,21,42,14,14,0,0,14,1 (1ct 0st),0.3329999999999999,1996,2004,MTG Elliott ,AUS
696,13,23,14,14,0,0,14,2 (2ct 0st),0.608,1921,1929,PGH Fender ,ENG
697,20,32,14,14,0,0,14,2 (2ct 0st),0.437,1999,2004,TR Gripper ,ZIM
698,36,61,14,14,0,0,14,2 (2ct 0st),0.2289999999999999,1951,1961,SP Gupte ,INDIA
699,23,38,14,14,0,0,14,3 (3ct 0st),0.368,1992,2002,CZ Harris ,NZ
700,22,38,14,14,0,0,14,2 (2ct 0st),0.368,1930,1954,GA Headley ,WI
701,8,16,14,14,0,0,14,3 (3ct 0st),0.875,2014,2015,CJ Jordan ,ENG
702,24,46,14,14,0,0,14,2 (2ct 0st),0.304,1973,1977,BD Julien ,WI
703,13,24,14,14,0,0,14,4 (4ct 0st),0.583,2000,2006,M Kaif ,INDIA
704,29,55,14,14,0,0,14,2 (2ct 0st),0.254,1961,1969,BR Knight ,ENG
705,21,39,14,14,0,0,14,2 (2ct 0st),0.358,1970,1974,BW Luckhurst ,ENG
706,14,27,14,14,0,0,14,1 (1ct 0st),0.518,1946,1950,CL McCool ,AUS
707,47,90,14,14,0,0,14,2 (2ct 0st),0.155,1952,1961,CC McDonald ,AUS
708,21,38,14,14,0,0,14,2 (2ct 0st),0.368,1920,1926,AA Mailey ,AUS
709,71,128,14,14,0,0,14,1 (1ct 0st),0.109,2000,2013,CS Martin ,NZ
710,5,7,14,14,0,13,1,4 (4ct 0st),2.0,2016,2019,Mohammad Rizwan ,PAK
711,48,76,14,14,0,0,14,2 (2ct 0st),0.184,1987,1997,DK Morrison ,NZ
712,8,14,14,10,4,10,0,3 (1ct 2st),1.0,1881,1888,R Pilling ,ENG
713,13,25,14,14,0,0,14,2 (2ct 0st),0.56,1903,1914,AE Relf ,ENG
714,30,48,14,14,0,0,14,2 (2ct 0st),0.291,1982,1987,GM Ritchie ,AUS
715,26,43,14,14,0,0,14,2 (2ct 0st),0.325,1935,1951,EAB Rowan ,SA
716,22,42,14,14,0,0,14,1 (1ct 0st),0.3329999999999999,2015,2019,MJ Santner ,NZ
717,58,100,14,14,0,0,14,2 (2ct 0st),0.14,2008,2019,Tamim Iqbal ,BDESH
718,19,35,14,14,0,0,14,2 (2ct 0st),0.4,1951,1958,CB van Ryneveld ,SA
719,14,26,14,14,0,0,14,2 (2ct 0st),0.5379999999999999,2007,2009,SM Warnapura ,SL
720,30,53,14,14,0,0,14,3 (3ct 0st),0.264,1994,2002,C White ,ENG
721,20,36,14,14,0,0,14,2 (2ct 0st),0.3879999999999999,1938,1950,NWD Yardley ,ENG
722,13,26,13,13,0,0,13,3 (3ct 0st),0.5,1888,1902,R Abel ,ENG
723,24,38,13,13,0,5,8,3 (3ct 0st),0.342,1933,1952,L Amarnath ,INDIA
724,16,30,13,13,0,0,13,2 (2ct 0st),0.433,1982,1989,J Arun Lal ,INDIA
725,23,38,13,13,0,0,13,2 (2ct 0st),0.342,1980,1988,CWJ Athey ,ENG
726,4,7,13,12,1,12,0,4 (4ct 0st),1.857,1979,1981,DL Bairstow ,ENG
727,15,27,13,13,0,0,13,3 (3ct 0st),0.481,2009,2012,AB Barath ,WI
728,19,31,13,13,0,0,13,3 (3ct 0st),0.419,2001,2005,AM Blignaut ,ZIM
729,25,42,13,13,0,0,13,1 (1ct 0st),0.309,1977,1986,RJ Bright ,AUS
730,9,18,13,13,0,0,13,2 (2ct 0st),0.722,1961,1965,HD Bromfield ,SA
731,19,35,13,13,0,0,13,3 (3ct 0st),0.371,1963,1972,MC Carew ,WI
732,24,43,13,13,0,0,13,3 (3ct 0st),0.302,1949,1955,JE Cheetham ,SA
733,19,35,13,13,0,0,13,2 (2ct 0st),0.371,1920,1926,HL Collins ,AUS
734,12,23,13,13,0,0,13,3 (3ct 0st),0.565,1906,1908,JN Crawford ,ENG
735,8,15,13,13,0,13,0,3 (3ct 0st),0.866,2001,2002,D Dasgupta ,INDIA
736,18,33,13,13,0,0,13,2 (2ct 0st),0.3929999999999999,1932,1938,JHW Fingleton ,AUS
737,8,16,13,13,0,0,13,2 (2ct 0st),0.812,1903,1907,RE Foster ,ENG
738,14,24,13,13,0,0,13,2 (2ct 0st),0.541,1924,1934,G Geary ,ENG
739,5,9,13,10,3,10,0,4 (3ct 1st),1.444,1982,1982,HM Goonatilleke ,SL
740,58,99,13,13,0,0,13,2 (2ct 0st),0.131,1994,2003,D Gough ,ENG
741,7,14,13,13,0,0,13,3 (3ct 0st),0.928,1935,1939,RS Grant ,WI
742,27,52,13,13,0,0,13,2 (2ct 0st),0.25,2010,2015,RJ Harris ,AUS
743,24,42,13,13,0,0,13,2 (2ct 0st),0.309,1911,1926,JW Hearne ,ENG
744,18,28,13,13,0,0,13,2 (2ct 0st),0.4639999999999999,1979,1985,AMJ Hilditch ,AUS
745,22,43,13,13,0,0,13,1 (1ct 0st),0.302,1925,1934,AF Kippax ,AUS
746,13,25,13,13,0,0,13,3 (3ct 0st),0.52,2018,2019,M Labuschagne ,AUS
747,41,75,13,13,0,0,13,2 (2ct 0st),0.173,1928,1938,M Leyland ,ENG
748,26,38,13,13,0,0,13,2 (2ct 0st),0.342,1951,1958,AR MacGibbon ,NZ
749,16,27,13,13,0,0,13,2 (2ct 0st),0.481,1952,1955,Maqsood Ahmed ,PAK
750,16,28,13,13,0,0,13,2 (2ct 0st),0.4639999999999999,1927,1932,DPB Morkel ,SA
751,32,56,13,13,0,0,13,2 (2ct 0st),0.2319999999999999,1992,2001,DJ Nash ,NZ
752,17,30,13,13,0,0,13,2 (2ct 0st),0.433,1880,1886,GE Palmer ,AUS
753,24,43,13,13,0,0,13,3 (3ct 0st),0.302,2006,2017,JS Patel ,NZ
754,15,26,13,13,0,0,13,2 (2ct 0st),0.5,1896,1902,KS Ranjitsinhji ,ENG
755,6,11,13,11,2,11,0,3 (2ct 1st),1.181,2002,2002,A Ratra ,INDIA
756,23,37,13,13,0,0,13,1 (1ct 0st),0.351,1997,2002,GJ Rennie ,ZIM
757,56,101,13,13,0,0,13,2 (2ct 0st),0.128,2009,2019,KAJ Roach ,WI
758,41,70,13,13,0,0,13,2 (2ct 0st),0.185,1958,1973,Saeed Ahmed ,PAK
759,12,22,13,13,0,0,13,3 (3ct 0st),0.59,1977,1978,CS Serjeant ,AUS
760,27,53,13,13,0,0,13,2 (2ct 0st),0.245,1958,1965,JS Solomon ,WI
761,36,70,13,13,0,0,13,1 (1ct 0st),0.185,1950,1962,AL Valentine ,WI
762,6,10,13,13,0,13,0,4 (4ct 0st),1.3,2015,2016,DJ Vilas ,SA
763,7,11,13,13,0,0,13,4 (4ct 0st),1.181,1979,1979,DF Whatmore ,AUS
764,32,61,13,13,0,0,13,2 (2ct 0st),0.213,2013,2019,CR Woakes ,ENG
765,11,19,13,13,0,0,13,3 (3ct 0st),0.684,1885,1899,J Worrall ,AUS
766,16,28,12,12,0,0,12,2 (2ct 0st),0.428,1921,1926,TJE Andrews ,AUS
767,41,74,12,12,0,0,12,1 (1ct 0st),0.162,1909,1926,W Bardsley ,AUS
768,27,52,12,12,0,0,12,2 (2ct 0st),0.23,1901,1914,SF Barnes ,ENG
769,21,38,12,12,0,0,12,2 (2ct 0st),0.315,1987,1995,WKM Benjamin ,WI
770,33,63,12,12,0,0,12,2 (2ct 0st),0.19,1884,1899,J Briggs ,ENG
771,7,12,12,9,3,9,0,3 (1ct 2st),1.0,1921,1923,G Brown ,ENG
772,14,24,12,12,0,0,12,3 (3ct 0st),0.5,1885,1895,W Bruce ,AUS
773,15,29,12,12,0,0,12,2 (2ct 0st),0.413,2018,2019,RJ Burns ,ENG
774,24,41,12,12,0,0,12,3 (3ct 0st),0.292,1922,1931,RH Catterall ,SA
775,21,36,12,12,0,0,12,2 (2ct 0st),0.3329999999999999,1993,1998,RK Chauhan ,INDIA
776,19,29,12,12,0,0,12,2 (2ct 0st),0.413,2005,2017,AG Cremer ,ZIM
777,29,55,12,12,0,0,12,2 (2ct 0st),0.218,2011,2019,PJ Cummins ,AUS
778,14,25,12,12,0,0,12,4 (4ct 0st),0.48,1993,1996,MH Dekker ,ZIM
779,5,10,12,10,2,10,0,3 (3ct 0st),1.2,2018,2019,BT Foakes ,ENG
780,31,56,12,12,0,0,12,1 (1ct 0st),0.214,2001,2013,JEC Franklin ,NZ
781,7,13,12,10,2,6,4,4 (3ct 1st),0.923,1947,1951,GM Fullerton ,SA
782,8,13,12,10,2,10,0,2 (2ct 0st),0.923,1892,1902,EA Halliwell ,SA
783,23,42,12,12,0,0,12,2 (2ct 0st),0.285,1977,1985,DW Hookes ,AUS
784,18,33,12,12,0,0,12,2 (2ct 0st),0.363,1898,1904,WP Howell ,AUS
785,13,21,12,12,0,0,12,3 (3ct 0st),0.5710000000000001,1998,2000,NC Johnson ,ZIM
786,12,21,12,12,0,0,12,2 (2ct 0st),0.5710000000000001,1882,1888,SP Jones ,AUS
787,46,91,12,12,0,0,12,1 (1ct 0st),0.131,1948,1959,JC Laker ,ENG
788,22,43,12,12,0,0,12,2 (2ct 0st),0.2789999999999999,1969,1978,AV Mankad ,INDIA
789,20,37,12,12,0,0,12,2 (2ct 0st),0.324,1965,1972,RW Morgan ,NZ
790,12,24,12,12,0,0,12,3 (3ct 0st),0.5,2014,2017,JDS Neesham ,NZ
791,34,57,12,12,0,0,12,2 (2ct 0st),0.21,1935,1951,AD Nourse ,SA
792,29,49,12,12,0,0,12,2 (2ct 0st),0.244,1980,1984,SM Patil ,INDIA
793,6,11,12,12,0,0,12,2 (2ct 0st),1.09,1996,1997,V Rathour ,INDIA
794,19,38,12,12,0,0,12,3 (3ct 0st),0.315,1929,1937,RWV Robins ,ENG
795,18,32,12,12,0,0,12,2 (2ct 0st),0.375,2008,2011,JD Ryder ,NZ
796,33,63,12,12,0,0,12,2 (2ct 0st),0.19,2003,2010,Salman Butt ,PAK
797,22,42,12,12,0,0,12,1 (1ct 0st),0.285,1950,1963,Rev.DS Sheppard ,ENG
798,46,86,12,12,0,0,12,2 (2ct 0st),0.139,1997,2007,Shoaib Akhtar ,PAK
799,7,12,12,10,2,10,0,3 (2ct 1st),1.0,1951,1955,RT Spooner ,ENG
800,42,74,12,12,0,0,12,1 (1ct 0st),0.162,1990,2001,PCR Tufnell ,ENG
801,16,31,12,12,0,0,12,2 (2ct 0st),0.387,2009,2011,Umar Akmal ,PAK
802,8,14,12,12,0,0,12,2 (2ct 0st),0.857,1987,1990,MRJ Veletta ,AUS
803,46,87,12,12,0,0,12,1 (1ct 0st),0.1369999999999999,2012,2019,N Wagner ,NZ
804,34,64,12,12,0,0,12,1 (1ct 0st),0.187,1972,1977,MHN Walker ,AUS
805,28,56,12,12,0,0,12,3 (3ct 0st),0.214,1948,1957,JH Wardle ,ENG
806,37,69,12,12,0,0,12,2 (2ct 0st),0.173,1937,1956,C Washbrook ,ENG
807,15,28,12,12,0,0,12,3 (3ct 0st),0.428,1949,1957,JC Watkins ,SA
808,17,29,12,12,0,0,12,2 (2ct 0st),0.413,1963,1969,BW Yuile ,NZ
809,22,43,11,11,0,0,11,2 (2ct 0st),0.255,1948,1958,DS Atkinson ,WI
810,19,35,11,11,0,0,11,2 (2ct 0st),0.314,1996,1999,AM Bacher ,SA
811,27,47,11,11,0,0,11,1 (1ct 0st),0.2339999999999999,1979,1987,RMH Binny ,INDIA
812,6,11,11,8,3,8,0,2 (2ct 0st),1.0,1899,1906,JH Board ,ENG
813,12,21,11,11,0,0,11,4 (4ct 0st),0.523,2017,2019,TB de Bruyn ,SA
814,5,9,11,7,4,6,1,3 (1ct 2st),1.222,1955,1956,CC Depeiaza ,WI
815,18,35,11,11,0,0,11,2 (2ct 0st),0.314,1993,1998,PS de Villiers ,SA
816,4,8,11,8,3,8,0,3 (3ct 0st),1.375,1928,1934,Harry Elliott ,ENG
817,34,56,11,11,0,0,11,1 (1ct 0st),0.196,1952,1962,Fazal Mahmood ,PAK
818,8,16,11,11,0,0,11,3 (3ct 0st),0.687,1948,1954,W Ferguson ,WI
819,11,20,11,11,0,0,11,2 (2ct 0st),0.55,1911,1912,FR Foster ,ENG
820,22,37,11,11,0,0,11,1 (1ct 0st),0.297,1948,1959,Ghulam Ahmed ,INDIA
821,48,92,11,11,0,0,11,1 (1ct 0st),0.119,1958,1969,WW Hall ,WI
822,14,25,11,11,0,0,11,2 (2ct 0st),0.44,1964,1969,Hanumant Singh ,INDIA
823,3,6,11,11,0,11,0,5 (5ct 0st),1.833,1968,1968,RI Harford ,NZ
824,30,48,11,11,0,0,11,2 (2ct 0st),0.2289999999999999,1946,1953,VS Hazare ,INDIA
825,20,38,11,11,0,0,11,2 (2ct 0st),0.289,1902,1909,AJY Hopkins ,AUS
826,5,10,11,8,3,8,0,4 (2ct 2st),1.1,1884,1885,J Hunter ,ENG
827,18,34,11,11,0,0,11,2 (2ct 0st),0.3229999999999999,1899,1912,GL Jessop ,ENG
828,19,33,11,11,0,0,11,2 (2ct 0st),0.3329999999999999,2008,2012,Junaid Siddique ,BDESH
829,15,27,11,11,0,0,11,2 (2ct 0st),0.407,2002,2005,RWT Key ,ENG
830,27,54,11,11,0,0,11,1 (1ct 0st),0.203,1998,2004,DS Lehmann ,AUS
831,21,38,11,11,0,0,11,1 (1ct 0st),0.289,1976,1986,JK Lever ,ENG
832,17,31,11,11,0,0,11,2 (2ct 0st),0.354,1970,1975,P Lever ,ENG
833,9,18,11,11,0,0,11,3 (3ct 0st),0.611,1974,1975,D Lloyd ,ENG
834,15,27,11,11,0,0,11,2 (2ct 0st),0.407,2017,2018,DJ Malan ,ENG
835,16,32,11,11,0,0,11,2 (2ct 0st),0.3429999999999999,2010,2012,EJG Morgan ,ENG
836,11,20,11,11,0,0,11,1 (1ct 0st),0.55,2000,2001,BA Murphy ,ZIM
837,29,49,11,11,0,0,11,2 (2ct 0st),0.2239999999999999,1958,1973,Nasim-ul-Ghani ,PAK
838,14,24,11,11,0,0,11,2 (2ct 0st),0.4579999999999999,1930,1939,MS Nichols ,ENG
839,8,14,11,11,0,0,11,2 (2ct 0st),0.785,2004,2007,MHW Papps ,NZ
840,5,9,11,8,3,8,0,3 (1ct 2st),1.222,1892,1895,H Philipson ,ENG
841,4,5,11,9,2,9,0,3 (3ct 0st),2.2,1979,1979,B Reddy ,INDIA
842,26,46,11,11,0,0,11,1 (1ct 0st),0.239,2009,2018,Rubel Hossain ,BDESH
843,16,31,11,11,0,0,11,3 (3ct 0st),0.354,2013,2015,HD Rutherford ,NZ
844,35,67,11,11,0,0,11,2 (2ct 0st),0.1639999999999999,2009,2014,Saeed Ajmal ,PAK
845,13,23,11,10,1,0,10,4 (4ct 0st),0.478,1995,2003,Saleem Elahi ,PAK
846,5,9,11,11,0,0,11,3 (3ct 0st),1.222,1996,2002,Shadab Kabir ,PAK
847,19,33,11,11,0,0,11,2 (2ct 0st),0.3329999999999999,2013,2019,Shan Masood ,PAK
848,17,33,11,11,0,0,11,2 (2ct 0st),0.3329999999999999,2013,2018,IS Sodhi ,NZ
849,18,31,11,11,0,0,11,3 (3ct 0st),0.354,1877,1887,FR Spofforth ,AUS
850,6,10,11,11,0,11,0,3 (3ct 0st),1.1,1897,1899,W Storer ,ENG
851,26,46,11,11,0,0,11,1 (1ct 0st),0.239,1995,2001,BC Strang ,ZIM
852,39,68,11,11,0,0,11,2 (2ct 0st),0.161,1924,1935,MW Tate ,ENG
853,20,37,11,11,0,0,11,1 (1ct 0st),0.297,1920,1926,JM Taylor ,AUS
854,47,91,11,11,0,0,11,2 (2ct 0st),0.12,2003,2013,Umar Gul ,PAK
855,15,30,11,11,0,0,11,2 (2ct 0st),0.366,1963,1967,PL van der Merwe ,SA
856,9,17,11,11,0,0,11,2 (2ct 0st),0.647,2002,2004,M van Jaarsveld ,SA
857,3,6,11,11,0,11,0,4 (4ct 0st),1.833,1985,1985,S Viswanath ,INDIA
858,18,34,11,11,0,0,11,2 (2ct 0st),0.3229999999999999,1929,1934,TW Wall ,AUS
859,25,48,11,11,0,0,11,2 (2ct 0st),0.2289999999999999,1998,2005,PJ Wiseman ,NZ
860,4,7,11,10,1,10,0,2 (2ct 0st),1.571,1938,1939,A Wood ,ENG
861,4,8,11,11,0,0,11,5 (5ct 0st),1.375,1977,1979,Yajurvindra Singh ,INDIA
862,39,69,10,10,0,0,10,2 (2ct 0st),0.144,1960,1966,DA Allen ,ENG
863,15,20,10,10,0,0,10,3 (3ct 0st),0.5,2000,2003,Al Sahariar ,BDESH
864,12,23,10,10,0,0,10,2 (2ct 0st),0.434,2003,2005,Asim Kamal ,PAK
865,12,24,10,10,0,0,10,2 (2ct 0st),0.416,1965,1970,A Bacher ,SA
866,5,10,10,10,0,0,10,2 (2ct 0st),1.0,2013,2014,GJ Bailey ,AUS
867,21,40,10,10,0,0,10,2 (2ct 0st),0.25,1961,1966,KC Bland ,SA
868,12,23,10,10,0,0,10,1 (1ct 0st),0.434,1879,1884,HF Boyle ,AUS
869,27,49,10,10,0,0,10,2 (2ct 0st),0.204,2011,2016,DAJ Bracewell ,NZ
870,25,41,10,10,0,0,10,2 (2ct 0st),0.243,1984,1989,BC Broad ,ENG
871,14,26,10,10,0,0,10,2 (2ct 0st),0.384,1953,1966,ME Chapple ,NZ
872,35,63,10,10,0,0,10,1 (1ct 0st),0.158,1965,1978,RO Collinge ,NZ
873,21,35,10,10,0,0,10,2 (2ct 0st),0.285,1996,2001,RDB Croft ,ENG
874,15,28,10,10,0,0,10,2 (2ct 0st),0.357,1983,1988,WW Davis ,WI
875,9,17,10,10,0,0,10,3 (3ct 0st),0.588,1947,1949,OC Dawson ,SA
876,41,66,10,10,0,0,10,2 (2ct 0st),0.151,1979,1989,GR Dilley ,ENG
877,33,57,10,10,0,0,10,2 (2ct 0st),0.175,1979,1983,DR Doshi ,INDIA
878,12,17,10,10,0,0,10,2 (2ct 0st),0.588,1929,1931,KS Duleepsinhji ,ENG
879,30,56,10,10,0,0,10,2 (2ct 0st),0.178,1977,1984,J Dyson ,AUS
880,55,102,10,10,0,0,10,1 (1ct 0st),0.098,2003,2012,FH Edwards ,WI
881,40,69,10,10,0,0,10,2 (2ct 0st),0.144,2000,2012,CRD Fernando ,SL
882,24,40,10,10,0,0,10,2 (2ct 0st),0.25,2008,2013,DR Flynn ,NZ
883,21,39,10,10,0,0,10,1 (1ct 0st),0.256,1982,1985,G Fowler ,ENG
884,19,32,10,10,0,0,10,3 (3ct 0st),0.312,1998,2000,MW Goodwin ,ZIM
885,12,18,10,10,0,0,10,2 (2ct 0st),0.555,1930,1935,GC Grant ,WI
886,2,4,10,7,3,7,0,3 (3ct 0st),2.5,1939,1939,RE Grieveson ,SA
887,13,23,10,10,0,0,10,2 (2ct 0st),0.434,2017,2019,Haris Sohail ,PAK
888,16,31,10,10,0,0,10,2 (2ct 0st),0.322,2018,2019,TM Head ,AUS
889,11,22,10,10,0,0,10,3 (3ct 0st),0.4539999999999999,1921,1929,HSTL Hendry ,AUS
890,20,36,10,10,0,0,10,2 (2ct 0st),0.2769999999999999,1893,1905,Hon.FS Jackson ,ENG
891,40,54,10,10,0,0,10,2 (2ct 0st),0.185,2001,2007,Javed Omar ,BDESH
892,4,8,10,10,0,0,10,3 (3ct 0st),1.25,1999,1999,DRE Joseph ,WI
893,11,16,10,10,0,0,10,2 (2ct 0st),0.625,1993,1999,RS Kalpage ,SL
894,46,81,10,10,0,0,10,2 (2ct 0st),0.123,1980,1989,GF Lawson ,AUS
895,8,16,10,10,0,0,10,2 (2ct 0st),0.625,1904,1909,PA McAlister ,AUS
896,17,32,10,10,0,0,10,2 (2ct 0st),0.312,2008,2011,TG McIntosh ,NZ
897,6,11,10,9,1,9,0,3 (3ct 0st),0.909,1954,1955,CA McWatt ,WI
898,2,4,10,8,2,8,0,3 (2ct 1st),2.5,1962,1962,IL Mendonca ,WI
899,12,22,10,10,0,0,10,2 (2ct 0st),0.4539999999999999,1877,1887,WE Midwinter ,AUS
900,47,91,10,10,0,0,10,1 (1ct 0st),0.109,2013,2019,Mohammed Shami ,INDIA
901,8,14,10,9,1,6,3,3 (2ct 1st),0.7140000000000001,2016,2018,PJ Moor ,ZIM
902,10,16,10,10,0,0,10,3 (3ct 0st),0.625,1986,1989,MD Moxon ,ENG
903,19,33,10,10,0,0,10,2 (2ct 0st),0.303,2011,2017,Nasir Hossain ,BDESH
904,24,48,10,10,0,0,10,1 (1ct 0st),0.208,2009,2013,PP Ojha ,INDIA
905,30,51,10,10,0,0,10,2 (2ct 0st),0.196,1995,2002,HK Olonga ,ZIM
906,50,90,10,10,0,0,10,1 (1ct 0st),0.111,2006,2013,MS Panesar ,ENG
907,30,56,10,10,0,0,10,2 (2ct 0st),0.178,1982,1992,DR Pringle ,ENG
908,23,39,10,10,0,0,10,3 (3ct 0st),0.256,1994,2001,KR Pushpakumara ,SL
909,15,30,10,10,0,0,10,2 (2ct 0st),0.3329999999999999,1948,1953,AF Rae ,WI
910,20,39,10,10,0,0,10,2 (2ct 0st),0.256,1907,1912,VS Ransford ,AUS
911,27,52,10,10,0,0,10,2 (2ct 0st),0.192,1998,2010,Shahid Afridi ,PAK
912,30,55,10,10,0,0,10,1 (1ct 0st),0.181,1965,1973,BR Taylor ,NZ
913,13,23,10,10,0,0,10,2 (2ct 0st),0.434,1987,1991,PL Taylor ,AUS
914,6,12,10,5,5,5,0,3 (1ct 2st),0.833,1882,1886,EFS Tylecote ,ENG
915,10,20,10,10,0,0,10,2 (2ct 0st),0.5,2013,2015,KDK Vithanage ,SL
916,14,25,10,10,0,0,10,2 (2ct 0st),0.4,2011,2017,MN Waller ,ZIM
917,2,4,10,10,0,10,0,5 (5ct 0st),2.5,2009,2009,CAK Walton ,WI
918,21,36,10,10,0,0,10,2 (2ct 0st),0.2769999999999999,1952,1959,Waqar Hasan ,PAK
919,23,35,10,10,0,0,10,2 (2ct 0st),0.285,1982,1987,S Wettimuny ,SL
920,17,31,10,10,0,0,10,2 (2ct 0st),0.322,1906,1912,GC White ,SA
921,3,6,10,9,1,9,0,3 (3ct 0st),1.666,1989,1992,AGD Wickremasinghe ,SL
922,19,36,10,10,0,0,10,2 (2ct 0st),0.2769999999999999,1975,1981,RA Woolmer ,ENG
923,34,62,10,10,0,0,10,2 (2ct 0st),0.161,1938,1951,DVP Wright ,ENG
924,35,64,10,10,0,0,10,1 (1ct 0st),0.156,1979,1987,NS Yadav ,INDIA
925,3,6,10,8,2,8,0,3 (3ct 0st),1.666,1986,1986,Zulqarnain ,PAK
926,11,21,9,9,0,0,9,2 (2ct 0st),0.428,1992,1993,PK Amre ,INDIA
927,34,61,9,9,0,0,9,2 (2ct 0st),0.147,1967,1975,GG Arnold ,ENG
928,10,20,9,9,0,0,9,2 (2ct 0st),0.45,1884,1892,W Attewell ,ENG
929,15,29,9,9,0,0,9,1 (1ct 0st),0.31,1881,1887,W Bates ,ENG
930,18,29,9,9,0,0,9,2 (2ct 0st),0.31,1913,1924,JM Blanckenberg ,SA
931,7,13,9,9,0,0,9,2 (2ct 0st),0.6920000000000001,1903,1905,BJT Bosanquet ,ENG
932,7,13,9,9,0,0,9,2 (2ct 0st),0.6920000000000001,1982,1983,G Cook ,ENG
933,19,36,9,9,0,0,9,1 (1ct 0st),0.25,1982,1985,NG Cowans ,ENG
934,15,28,9,9,0,0,9,2 (2ct 0st),0.321,1973,1977,IC Davis ,AUS
935,17,27,9,9,0,0,9,2 (2ct 0st),0.3329999999999999,1982,1986,ALF de Mel ,SL
936,28,45,9,9,0,0,9,2 (2ct 0st),0.2,1959,1968,RB Desai ,INDIA
937,23,42,9,9,0,0,9,3 (3ct 0st),0.214,1911,1925,JWHT Douglas ,ENG
938,7,13,9,9,0,0,9,3 (3ct 0st),0.6920000000000001,1877,1882,T Emmett ,ENG
939,19,37,9,9,0,0,9,2 (2ct 0st),0.243,1954,1961,LE Favell ,AUS
940,20,38,9,9,0,0,9,2 (2ct 0st),0.236,1994,2001,DW Fleming ,AUS
941,46,80,9,9,0,0,9,2 (2ct 0st),0.1119999999999999,1989,1998,ARC Fraser ,ENG
942,8,16,9,9,0,0,9,2 (2ct 0st),0.562,1969,1975,JH Hampshire ,ENG
943,23,44,9,9,0,0,9,1 (1ct 0st),0.204,1935,1948,J Hardstaff jnr ,ENG
944,14,22,9,9,0,0,9,1 (1ct 0st),0.409,1994,1995,MN Hart ,NZ
945,27,50,9,9,0,0,9,1 (1ct 0st),0.18,1963,1968,NJN Hawke ,AUS
946,6,12,9,9,0,0,9,2 (2ct 0st),0.75,2005,2008,BJ Hodge ,AUS
947,11,19,9,9,0,0,9,2 (2ct 0st),0.473,1997,1999,RIC Holder ,WI
948,4,6,9,9,0,9,0,3 (3ct 0st),1.5,2008,2010,GJ Hopkins ,NZ
949,7,14,9,9,0,0,9,2 (2ct 0st),0.642,1907,1909,KL Hutchings ,ENG
950,5,9,9,9,0,0,9,2 (2ct 0st),1.0,1971,1971,RA Hutton ,ENG
951,4,8,9,6,3,6,0,2 (2ct 0st),1.125,1964,1969,KS Indrajitsinhji ,INDIA
952,8,16,9,9,0,0,9,2 (2ct 0st),0.562,1953,1957,HJ Keith ,SA
953,13,25,9,9,0,0,9,2 (2ct 0st),0.36,1957,1961,LF Kline ,AUS
954,4,8,9,8,1,8,0,3 (3ct 0st),1.125,1953,1953,RA Legall ,WI
955,25,39,9,9,0,0,9,1 (1ct 0st),0.23,1955,1965,SN McGregor ,NZ
956,17,31,9,9,0,0,9,1 (1ct 0st),0.29,1894,1905,CE McLeod ,AUS
957,21,34,9,9,0,0,9,2 (2ct 0st),0.264,1982,1988,RS Madugalle ,SL
958,35,57,9,9,0,0,9,1 (1ct 0st),0.157,1982,1993,Maninder Singh ,INDIA
959,19,34,9,9,0,0,9,1 (1ct 0st),0.264,1980,1990,Mansoor Akhtar ,PAK
960,4,8,9,8,1,6,2,4 (3ct 1st),1.125,1951,1955,MK Mantri ,INDIA
961,36,52,9,9,0,0,9,1 (1ct 0st),0.173,2001,2009,Mashrafe Mortaza ,BDESH
962,18,36,9,9,0,0,9,2 (2ct 0st),0.25,1957,1963,I Meckiff ,AUS
963,24,37,9,9,0,0,9,1 (1ct 0st),0.243,1982,1988,LRD Mendis ,SL
964,6,12,9,9,0,0,9,2 (2ct 0st),0.75,1933,1936,A Mitchell ,ENG
965,8,13,9,9,0,0,9,2 (2ct 0st),0.6920000000000001,1989,1992,TM Moody ,AUS
966,17,29,9,9,0,0,9,2 (2ct 0st),0.31,1973,1982,JFM Morrison ,NZ
967,32,58,9,9,0,0,9,1 (1ct 0st),0.155,1961,1969,RC Motz ,NZ
968,6,11,9,9,0,9,0,3 (3ct 0st),0.818,1965,1965,Naushad Ali ,PAK
969,17,32,9,9,0,0,9,2 (2ct 0st),0.281,1921,1936,EP Nupen ,SA
970,19,37,9,9,0,0,9,1 (1ct 0st),0.243,1964,1973,Pervez Sajjad ,PAK
971,15,29,9,9,0,0,9,2 (2ct 0st),0.31,2003,2014,RJ Peterson ,SA
972,28,54,9,9,0,0,9,2 (2ct 0st),0.166,1961,1970,PM Pollock ,SA
973,21,40,9,9,0,0,9,1 (1ct 0st),0.225,2013,2018,Rahat Ali ,PAK
974,43,82,9,9,0,0,9,2 (2ct 0st),0.109,1950,1961,S Ramadhin ,WI
975,9,17,9,9,0,0,9,2 (2ct 0st),0.529,2008,2011,Raqibul Hasan ,BDESH
976,23,36,9,9,0,0,9,1 (1ct 0st),0.25,1983,1992,RJ Ratnayake ,SL
977,19,35,9,9,0,0,9,3 (3ct 0st),0.257,1979,1986,JF Reid ,NZ
978,47,90,9,9,0,0,9,1 (1ct 0st),0.1,1974,1983,AME Roberts ,WI
979,38,63,9,9,0,0,9,1 (1ct 0st),0.142,2005,2015,Shahadat Hossain ,BDESH
980,16,29,9,9,0,0,9,1 (1ct 0st),0.31,2010,2014,S Shillingford ,WI
981,51,90,9,9,0,0,9,2 (2ct 0st),0.1,1983,1999,NS Sidhu ,INDIA
982,25,46,9,9,0,0,9,1 (1ct 0st),0.195,1896,1911,JH Sinclair ,SA
983,9,16,9,9,0,0,9,2 (2ct 0st),0.562,1983,1986,L Sivaramakrishnan ,INDIA
984,17,32,9,9,0,0,9,2 (2ct 0st),0.281,1986,1991,GC Small ,ENG
985,10,18,9,9,0,0,9,3 (3ct 0st),0.5,2004,2006,DR Smith ,WI
986,26,46,9,9,0,0,9,2 (2ct 0st),0.195,1955,1959,OG Smith ,WI
987,4,8,9,7,2,7,0,3 (3ct 0st),1.125,1927,1928,RT Stanyforth ,ENG
988,10,19,9,9,0,0,9,2 (2ct 0st),0.473,1922,1930,GTS Stevens ,ENG
989,9,15,9,9,0,0,9,3 (3ct 0st),0.6,1965,1968,V Subramanya ,INDIA
990,6,10,9,6,3,6,0,2 (1ct 1st),0.9,1980,1980,Taslim Arif ,PAK
991,34,62,9,9,0,0,9,2 (2ct 0st),0.145,1980,1993,Tauseef Ahmed ,PAK
992,15,28,9,9,0,0,9,2 (2ct 0st),0.321,1977,1980,PM Toohey ,AUS
993,9,17,9,9,0,0,9,2 (2ct 0st),0.529,1947,1949,L Tuckett ,SA
994,7,13,9,9,0,0,9,2 (2ct 0st),0.6920000000000001,1997,1999,PA Wallace ,WI
995,10,18,9,9,0,0,9,2 (2ct 0st),0.5,2013,2018,SC Williams ,ZIM
996,22,44,8,8,0,0,8,1 (1ct 0st),0.181,2007,2014,Abdur Rehman ,PAK
997,21,30,8,8,0,0,8,2 (2ct 0st),0.266,1947,1959,HR Adhikari ,INDIA
998,9,15,8,8,0,0,8,2 (2ct 0st),0.5329999999999999,1989,1995,Akram Raza ,PAK
999,25,43,8,8,0,0,8,2 (2ct 0st),0.186,1954,1962,Alimuddin ,PAK
1000,10,19,8,8,0,0,8,2 (2ct 0st),0.421,1903,1907,EG Arnold ,ENG
1001,10,18,8,8,0,0,8,1 (1ct 0st),0.444,1961,1968,GA Bartlett ,NZ
1002,8,16,8,8,0,0,8,2 (2ct 0st),0.5,1986,1990,CA Best ,WI
1003,18,36,8,8,0,0,8,2 (2ct 0st),0.222,1994,1998,MG Bevan ,AUS
1004,2,4,8,8,0,8,0,5 (5ct 0st),2.0,1964,1964,JG Binks ,ENG
1005,43,79,8,8,0,0,8,2 (2ct 0st),0.1009999999999999,1989,1998,IR Bishop ,WI
1006,18,32,8,8,0,0,8,1 (1ct 0st),0.25,2001,2009,SE Bond ,NZ
1007,23,43,8,8,0,0,8,1 (1ct 0st),0.186,2009,2013,TT Bresnan ,ENG
1008,5,9,8,7,1,7,0,2 (2ct 0st),0.888,1910,1912,T Campbell ,SA
1009,19,27,8,8,0,0,8,2 (2ct 0st),0.296,1949,1958,HB Cave ,NZ
1010,7,13,8,8,0,3,5,3 (3ct 0st),0.615,2014,2018,BB Chari ,ZIM
1011,4,6,8,5,3,5,0,3 (2ct 1st),1.3330000000000002,1930,1930,WL Cornford ,ENG
1012,21,40,8,8,0,0,8,2 (2ct 0st),0.2,1904,1912,A Cotter ,AUS
1013,27,52,8,8,0,0,8,2 (2ct 0st),0.153,1977,1982,CEH Croft ,WI
1014,12,23,8,8,0,0,8,3 (3ct 0st),0.347,1933,1937,LS Darling ,AUS
1015,17,27,8,8,0,0,8,2 (2ct 0st),0.296,1924,1931,HG Deane ,SA
1016,11,21,8,8,0,0,8,2 (2ct 0st),0.38,1905,1910,D Denton ,ENG
1017,36,68,8,8,0,0,8,2 (2ct 0st),0.1169999999999999,2010,2016,ST Finn ,ENG
1018,21,35,8,8,0,0,8,2 (2ct 0st),0.228,1983,1991,TJ Franklin ,NZ
1019,15,27,8,8,0,0,8,1 (1ct 0st),0.296,1964,1973,N Gifford ,ENG
1020,15,29,8,8,0,0,8,2 (2ct 0st),0.275,1973,1977,GJ Gilmour ,AUS
1021,26,45,8,8,0,0,8,2 (2ct 0st),0.177,1969,1978,DR Hadlee ,NZ
1022,11,19,8,8,0,0,8,2 (2ct 0st),0.421,1899,1912,S Haigh ,ENG
1023,11,21,8,8,0,0,8,2 (2ct 0st),0.38,2015,2016,AD Hales ,ENG
1024,2,4,8,8,0,8,0,3 (3ct 0st),2.0,1998,1999,WK Hegg ,ENG
1025,14,28,8,8,0,0,8,2 (2ct 0st),0.285,1955,1962,PS Heine ,SA
1026,7,12,8,8,0,0,8,2 (2ct 0st),0.6659999999999999,1967,1971,RNS Hobbs ,ENG
1027,17,32,8,8,0,0,8,2 (2ct 0st),0.25,1954,1959,JKC Holt ,WI
1028,20,38,8,8,0,0,8,1 (1ct 0st),0.21,2011,2015,Imran Tahir ,SA
1029,9,18,8,8,0,0,8,3 (3ct 0st),0.444,1950,1957,DJ Insole ,ENG
1030,16,30,8,8,0,0,8,2 (2ct 0st),0.266,2009,2014,Khurram Manzoor ,PAK
1031,12,23,8,8,0,0,8,3 (3ct 0st),0.347,1992,1994,PN Kirsten ,SA
1032,5,10,8,7,1,7,0,2 (2ct 0st),0.8,1971,1971,P Krishnamurthy ,INDIA
1033,21,40,8,8,0,0,8,2 (2ct 0st),0.2,2005,2014,KMDN Kulasekara ,SL
1034,21,38,8,8,0,0,8,2 (2ct 0st),0.21,2013,2018,B Kumar ,INDIA
1035,5,10,8,8,0,0,8,3 (3ct 0st),0.8,1991,1998,CB Lambert ,WI
1036,15,23,8,8,0,0,8,1 (1ct 0st),0.347,1935,1939,ACB Langton ,SA
1037,13,22,8,8,0,0,8,2 (2ct 0st),0.363,1980,1991,W Larkins ,ENG
1038,15,28,8,8,0,0,8,1 (1ct 0st),0.285,1899,1909,FJ Laver ,AUS
1039,3,6,8,8,0,8,0,4 (4ct 0st),1.3330000000000002,1971,1971,DM Lewis ,WI
1040,7,11,8,8,0,0,8,2 (2ct 0st),0.727,1930,1931,TC Lowry ,NZ
1041,7,13,8,8,0,0,8,2 (2ct 0st),0.615,2015,2015,A Lyth ,ENG
1042,12,22,8,8,0,0,8,2 (2ct 0st),0.363,1935,1938,EL McCormick ,AUS
1043,3,5,8,8,0,7,1,3 (3ct 0st),1.6,1950,1955,AJW McIntyre ,ENG
1044,5,6,8,7,1,7,0,3 (2ct 1st),1.3330000000000002,1955,1956,TG McMahon ,NZ
1045,13,23,8,8,0,0,8,2 (2ct 0st),0.347,1929,1932,Q McMillan ,SA
1046,11,20,8,8,0,0,8,2 (2ct 0st),0.4,1938,1949,A Melville ,SA
1047,3,5,8,6,2,6,0,3 (3ct 0st),1.6,1969,1969,BD Milburn ,NZ
1048,22,40,8,8,0,0,8,1 (1ct 0st),0.2,2008,2016,A Mishra ,INDIA
1049,4,8,8,8,0,0,8,2 (2ct 0st),1.0,1978,1979,MV Narasimha Rao ,INDIA
1050,3,5,8,5,3,5,0,3 (0ct 3st),1.6,2017,2018,Nurul Hasan ,BDESH
1051,29,54,8,8,0,0,8,1 (1ct 0st),0.148,2003,2008,IK Pathan ,INDIA
1052,37,68,8,8,0,0,8,2 (2ct 0st),0.1169999999999999,2002,2009,DBL Powell ,WI
1053,12,24,8,8,0,0,8,2 (2ct 0st),0.3329999999999999,1998,2002,D Ramnarine ,WI
1054,17,33,8,8,0,0,8,1 (1ct 0st),0.242,1882,1893,JM Read ,ENG
1055,11,21,8,8,0,0,8,1 (1ct 0st),0.38,2016,2018,MT Renshaw ,AUS
1056,29,49,8,8,0,0,8,1 (1ct 0st),0.163,1984,1989,RT Robinson ,ENG
1057,10,16,8,8,0,0,8,3 (3ct 0st),0.5,1920,1923,CAG Russell ,ENG
1058,6,12,8,8,0,0,8,2 (2ct 0st),0.6659999999999999,1996,1997,RG Samuels ,WI
1059,8,13,8,8,0,0,8,2 (2ct 0st),0.615,1884,1886,HJH Scott ,AUS
1060,19,34,8,8,0,0,8,1 (1ct 0st),0.235,1954,1962,Shujauddin ,PAK
1061,8,14,8,8,0,0,8,2 (2ct 0st),0.5710000000000001,2014,2016,Shuvagata Hom ,BDESH
1062,21,37,8,8,0,0,8,2 (2ct 0st),0.216,1963,1968,BW Sinclair ,NZ
1063,4,8,8,8,0,0,8,3 (3ct 0st),1.0,1882,1883,GB Studd ,ENG
1064,13,22,8,8,0,0,8,2 (2ct 0st),0.363,1992,1995,ML Su'a ,NZ
1065,16,30,8,8,0,0,8,2 (2ct 0st),0.266,1951,1954,R Tattersall ,ENG
1066,46,81,8,8,0,0,8,1 (1ct 0st),0.098,2003,2016,JE Taylor ,WI
1067,7,12,8,8,0,0,8,4 (4ct 0st),0.6659999999999999,1970,1993,AJ Traicos ,SA
1068,17,30,8,8,0,0,8,2 (2ct 0st),0.266,1887,1895,CTB Turner ,AUS
1069,13,24,8,8,0,0,8,2 (2ct 0st),0.3329999999999999,2016,2018,JM Vince ,ENG
1070,23,44,8,8,0,0,8,1 (1ct 0st),0.181,1951,1959,W Watson ,ENG
1071,10,16,8,8,0,0,8,3 (3ct 0st),0.5,1996,1999,AR Whittall ,ZIM
1072,9,15,8,8,0,0,8,1 (1ct 0st),0.5329999999999999,1930,1937,TS Worthington ,ENG
1073,5,10,8,8,0,8,0,2 (2ct 0st),0.8,2011,2011,RA Young ,NZ
1074,16,23,7,7,0,0,7,2 (2ct 0st),0.304,2004,2010,Aftab Ahmed ,BDESH
1075,9,18,7,7,0,0,7,2 (2ct 0st),0.3879999999999999,2018,2019,MA Agarwal ,INDIA
1076,21,35,7,7,0,0,7,1 (1ct 0st),0.2,1955,1972,JC Alabaster ,NZ
1077,12,23,7,7,0,0,7,2 (2ct 0st),0.304,1971,1977,Inshan Ali ,WI
1078,13,25,7,7,0,0,7,2 (2ct 0st),0.28,2013,2016,CJ Anderson ,NZ
1079,9,18,7,7,0,0,7,1 (1ct 0st),0.3879999999999999,1927,1930,WE Astill ,ENG
1080,4,8,7,7,0,0,7,2 (2ct 0st),0.875,1882,1883,Hon.IFW Bligh ,ENG
1081,26,46,7,7,0,0,7,2 (2ct 0st),0.152,1965,1969,DJ Brown ,ENG
1082,8,15,7,7,0,1,6,1 (1ct 0st),0.466,1894,1899,JT Brown ,ENG
1083,6,12,7,7,0,0,7,1 (1ct 0st),0.583,2010,2014,MA Carberry ,ENG
1084,16,30,7,7,0,0,7,1 (1ct 0st),0.233,1999,2005,UDU Chandana ,SL
1085,43,75,7,7,0,0,7,2 (2ct 0st),0.093,1975,1989,EJ Chatfield ,NZ
1086,4,8,7,6,1,6,0,3 (2ct 1st),0.875,1935,1935,CM Christiani ,WI
1087,32,61,7,7,0,0,7,1 (1ct 0st),0.114,1999,2006,PT Collins ,WI
1088,16,29,7,7,0,0,7,2 (2ct 0st),0.241,2012,2016,NRD Compton ,ENG
1089,7,13,7,7,0,0,7,2 (2ct 0st),0.5379999999999999,1948,1949,JF Crapp ,ENG
1090,3,6,7,6,1,6,0,3 (3ct 0st),1.166,1934,1936,Dilawar Hussain ,INDIA
1091,7,12,7,7,0,0,7,2 (2ct 0st),0.583,1937,1949,MP Donnelly ,NZ
1092,8,13,7,7,0,7,0,3 (3ct 0st),0.5379999999999999,1977,1981,GN Edwards ,NZ
1093,20,39,7,7,0,0,7,2 (2ct 0st),0.179,1972,1975,R Edwards ,AUS
1094,5,6,7,7,0,0,7,2 (2ct 0st),1.166,2003,2004,SM Ervine ,ZIM
1095,4,8,7,5,2,5,0,2 (0ct 2st),0.875,1931,1935,W Farrimond ,ENG
1096,5,10,7,7,0,0,7,4 (4ct 0st),0.7,2018,2018,AJ Finch ,AUS
1097,29,50,7,7,0,0,7,1 (1ct 0st),0.14,1983,1993,NA Foster ,ENG
1098,10,13,7,7,0,0,7,2 (2ct 0st),0.5379999999999999,1928,1933,GN Francis ,WI
1099,18,34,7,7,0,0,7,2 (2ct 0st),0.205,1952,1958,KJ Funston ,SA
1100,19,34,7,7,0,0,7,1 (1ct 0st),0.205,1877,1888,TW Garrett ,AUS
1101,17,26,7,7,0,0,7,2 (2ct 0st),0.2689999999999999,2002,2004,Hannan Sarkar ,BDESH
1102,63,115,7,7,0,0,7,1 (1ct 0st),0.06,2002,2009,SJ Harmison ,ENG
1103,9,17,7,7,0,0,7,2 (2ct 0st),0.411,2018,2019,MS Harris ,AUS
1104,26,44,7,7,0,0,7,1 (1ct 0st),0.159,1991,1999,UC Hathurusingha ,SL
1105,9,15,7,7,0,0,7,2 (2ct 0st),0.466,1973,1976,FC Hayes ,ENG
1106,15,25,7,7,0,0,7,1 (1ct 0st),0.28,1997,1999,DW Headley ,ENG
1107,16,29,7,7,0,0,7,2 (2ct 0st),0.241,2017,2019,SO Hetmyer ,WI
1108,27,50,7,7,0,0,7,2 (2ct 0st),0.14,2009,2012,BW Hilfenhaus ,AUS
1109,15,27,7,7,0,0,7,2 (2ct 0st),0.259,2002,2009,RO Hinds ,WI
1110,38,69,7,7,0,0,7,1 (1ct 0st),0.1009999999999999,1978,1984,RM Hogg ,AUS
1111,6,11,7,7,0,0,7,2 (2ct 0st),0.636,1929,1930,PM Hornibrook ,AUS
1112,3,6,7,7,0,7,0,3 (3ct 0st),1.166,1908,1908,J Humphries ,ENG
1113,11,20,7,7,0,0,7,4 (4ct 0st),0.35,2018,2019,Imam-ul-Haq ,PAK
1114,8,16,7,7,0,0,7,2 (2ct 0st),0.437,1929,1931,A Jackson ,AUS
1115,7,13,7,7,0,0,7,2 (2ct 0st),0.5379999999999999,2010,2013,Jahurul Islam ,BDESH
1116,11,22,7,7,0,0,7,2 (2ct 0st),0.318,2005,2008,PA Jaques ,AUS
1117,25,42,7,7,0,0,7,2 (2ct 0st),0.166,1960,1969,Javed Burki ,PAK
1118,9,14,7,7,0,0,7,2 (2ct 0st),0.5,2014,2016,LR Johnson ,WI
1119,15,28,7,7,0,0,7,1 (1ct 0st),0.25,1996,2000,SB Joshi ,INDIA
1120,17,30,7,7,0,0,7,1 (1ct 0st),0.233,1993,1995,VG Kambli ,INDIA
1121,13,26,7,7,0,0,7,2 (2ct 0st),0.2689999999999999,1962,1970,HR Lance ,SA
1122,15,26,7,7,0,0,7,2 (2ct 0st),0.2689999999999999,1896,1912,CB Llewellyn ,SA
1123,5,10,7,7,0,0,7,3 (3ct 0st),0.7,2002,2003,ML Love ,AUS
1124,12,23,7,7,0,0,7,4 (4ct 0st),0.304,1948,1951,SJE Loxton ,AUS
1125,28,53,7,7,0,0,7,1 (1ct 0st),0.132,2016,2019,KA Maharaj ,SA
1126,22,40,7,7,0,0,7,1 (1ct 0st),0.175,2004,2011,MF Maharoof ,SL
1127,40,73,7,7,0,0,7,1 (1ct 0st),0.095,1989,1997,DE Malcolm ,ENG
1128,30,59,7,7,0,0,7,2 (2ct 0st),0.118,2004,2010,SL Malinga ,SL
1129,6,10,7,7,0,0,7,2 (2ct 0st),0.7,1984,1995,Manzoor Elahi ,PAK
1130,7,14,7,7,0,0,7,2 (2ct 0st),0.5,2005,2009,XM Marshall ,WI
1131,8,12,7,7,0,0,7,2 (2ct 0st),0.583,2003,2005,S Matsikenyeri ,ZIM
1132,8,12,7,7,0,0,7,2 (2ct 0st),0.583,1912,1912,TJ Matthews ,AUS
1133,11,20,7,7,0,0,7,2 (2ct 0st),0.35,2011,2016,TMK Mawoyo ,ZIM
1134,10,18,7,7,0,0,7,2 (2ct 0st),0.3879999999999999,1933,1951,VM Merchant ,INDIA
1135,9,14,7,7,0,0,7,2 (2ct 0st),0.5,1966,1969,C Milburn ,ENG
1136,33,48,7,7,0,0,7,1 (1ct 0st),0.145,2000,2008,Mohammad Rafique ,BDESH
1137,36,66,7,7,0,0,7,2 (2ct 0st),0.106,2001,2012,Mohammad Sami ,PAK
1138,11,19,7,7,0,0,7,1 (1ct 0st),0.368,1934,1952,S Mushtaq Ali ,INDIA
1139,5,8,7,7,0,0,7,2 (2ct 0st),0.875,1952,1952,Nazar Mohammad ,PAK
1140,2,4,7,7,0,0,7,3 (3ct 0st),1.75,1956,1956,ASM Oakman ,ENG
1141,22,38,7,7,0,0,7,2 (2ct 0st),0.184,2005,2009,IE O'Brien ,NZ
1142,27,50,7,7,0,0,7,2 (2ct 0st),0.14,1932,1946,WJ O'Reilly ,AUS
1143,11,21,7,7,0,0,7,1 (1ct 0st),0.3329999999999999,2017,2018,HH Pandya ,INDIA
1144,20,37,7,7,0,0,7,1 (1ct 0st),0.1889999999999999,1931,1939,E Paynter ,ENG
1145,15,28,7,7,0,0,7,2 (2ct 0st),0.25,1964,1972,JSE Price ,ENG
1146,15,28,7,7,0,0,7,2 (2ct 0st),0.25,1947,1951,AMB Rowan ,SA
1147,13,25,7,7,0,0,7,2 (2ct 0st),0.28,2015,2017,Sami Aslam ,PAK
1148,10,14,7,7,0,0,7,2 (2ct 0st),0.5,1946,1952,VJ Scott ,NZ
1149,11,21,7,6,1,4,2,2 (1ct 1st),0.3329999999999999,1930,1939,JED Sealy ,WI
1150,6,11,7,7,0,0,7,2 (2ct 0st),0.636,2014,2014,Shamsur Rahman ,BDESH
1151,23,40,7,7,0,0,7,1 (1ct 0st),0.175,1984,1989,C Sharma ,INDIA
1152,3,6,7,5,2,5,0,4 (2ct 2st),1.166,1887,1888,M Sherwin ,ENG
1153,18,29,7,7,0,0,7,2 (2ct 0st),0.241,1928,1936,IJ Siedle ,SA
1154,26,48,7,7,0,0,7,1 (1ct 0st),0.145,1976,1983,Sikander Bakht ,PAK
1155,11,21,7,7,0,0,7,2 (2ct 0st),0.3329999999999999,2006,2008,LPC Silva ,SL
1156,25,42,7,7,0,0,7,2 (2ct 0st),0.166,1981,1990,MC Snedden ,NZ
1157,8,16,7,7,0,0,7,2 (2ct 0st),0.437,1975,1976,DS Steele ,ENG
1158,7,13,7,7,0,0,7,2 (2ct 0st),0.5379999999999999,2012,2016,JWA Taylor ,ENG
1159,19,31,7,7,0,0,7,1 (1ct 0st),0.225,1990,1995,SA Thomson ,NZ
1160,5,8,7,6,1,6,0,2 (2ct 0st),0.875,1937,1947,EWT Tindill ,NZ
1161,4,8,7,7,0,0,7,2 (2ct 0st),0.875,1967,1970,PHJ Trimborn ,SA
1162,21,38,7,7,0,0,7,2 (2ct 0st),0.184,1963,1967,TR Veivers ,AUS
1163,6,10,7,7,0,0,7,3 (3ct 0st),0.7,1999,2000,Wajahatullah Wasti ,PAK
1164,4,7,7,7,0,0,7,2 (2ct 0st),1.0,1925,1930,WW Whysall ,ENG
1165,35,65,7,7,0,0,7,2 (2ct 0st),0.107,1926,1934,WM Woodfull ,AUS
1166,2,3,7,7,0,7,0,3 (3ct 0st),2.333,1983,1984,RD Woolley ,AUS
1167,6,9,6,6,0,0,6,1 (1ct 0st),0.6659999999999999,1930,1935,EE Achong ,WI
1168,5,7,6,6,0,0,6,3 (3ct 0st),0.857,1999,2000,CJ Adams ,ENG
1169,3,5,6,5,1,5,0,2 (2ct 0st),1.2,2018,2019,Afsar Zazai ,AFG
1170,26,48,6,6,0,0,6,1 (1ct 0st),0.125,1998,2006,AB Agarkar ,INDIA
1171,4,7,6,6,0,0,6,2 (2ct 0st),0.857,2001,2001,HK Badani ,INDIA
1172,10,17,6,6,0,0,6,1 (1ct 0st),0.352,1959,1967,AA Baig ,INDIA
1173,10,20,6,6,0,0,6,3 (3ct 0st),0.3,2003,2005,OAC Banks ,WI
1174,19,35,6,6,0,0,6,1 (1ct 0st),0.171,1993,1995,Basit Ali ,PAK
1175,16,27,6,6,0,0,6,1 (1ct 0st),0.222,1929,1935,AJ Bell ,SA
1176,25,46,6,6,0,0,6,1 (1ct 0st),0.13,2003,2013,TL Best ,WI
1177,19,37,6,6,0,0,6,1 (1ct 0st),0.162,1901,1910,C Blythe ,ENG
1178,13,20,6,6,0,0,6,2 (2ct 0st),0.3,2007,2012,RS Bopara ,ENG
1179,7,11,6,6,0,0,6,2 (2ct 0st),0.545,1990,2001,GE Bradburn ,NZ
1180,7,13,6,6,0,0,6,1 (1ct 0st),0.461,1893,1899,W Brockwell ,ENG
1181,3,6,6,6,0,0,6,2 (2ct 0st),1.0,2019,2019,SSJ Brooks ,WI
1182,15,24,6,6,0,0,6,2 (2ct 0st),0.25,1987,1990,DJ Capel ,ENG
1183,6,9,6,6,0,6,0,2 (2ct 0st),0.6659999999999999,1912,1912,W Carkeek ,AUS
1184,14,24,6,6,0,0,6,2 (2ct 0st),0.25,2004,2014,E Chigumbura ,ZIM
1185,10,18,6,6,0,0,6,1 (1ct 0st),0.3329999999999999,1977,1979,WM Clark ,AUS
1186,30,58,6,6,0,0,6,1 (1ct 0st),0.103,1999,2007,CD Collymore ,WI
1187,11,20,6,6,0,0,6,2 (2ct 0st),0.3,2016,2017,SC Cook ,SA
1188,2,4,6,6,0,6,0,3 (3ct 0st),1.5,2000,2000,V Dahiya ,INDIA
1189,20,30,6,6,0,0,6,2 (2ct 0st),0.2,1982,1987,RL Dias ,SL
1190,10,17,6,6,0,0,6,2 (2ct 0st),0.352,1987,1992,AIC Dodemaide ,AUS
1191,1,2,6,5,1,5,0,5 (4ct 1st),3.0,1994,1994,PA Emery ,AUS
1192,14,27,6,6,0,0,6,1 (1ct 0st),0.222,1906,1910,FL Fane ,ENG
1193,6,10,6,6,0,0,6,3 (3ct 0st),0.6,1953,1955,CV Gadkari ,INDIA
1194,6,11,6,6,0,0,6,2 (2ct 0st),0.545,1904,1911,DRA Gehrs ,AUS
1195,2,3,6,6,0,0,6,4 (4ct 0st),2.0,1983,1983,Y Goonasekera ,SL
1196,5,10,6,6,0,0,6,3 (3ct 0st),0.6,1986,1987,AH Gray ,WI
1197,10,17,6,6,0,0,6,2 (2ct 0st),0.352,1983,1988,EJ Gray ,NZ
1198,6,12,6,6,0,0,6,2 (2ct 0st),0.5,2016,2017,DAS Gunaratne ,SL
1199,8,15,6,6,0,0,6,1 (1ct 0st),0.4,2017,2018,MD Gunathilaka ,SL
1200,11,17,6,6,0,0,6,2 (2ct 0st),0.352,1937,1951,WA Hadlee ,NZ
1201,9,15,6,6,0,0,6,3 (3ct 0st),0.4,1955,1965,PGZ Harris ,NZ
1202,15,28,6,6,0,0,6,1 (1ct 0st),0.214,1877,1885,TP Horan ,AUS
1203,7,13,6,6,0,0,6,2 (2ct 0st),0.461,1911,1912,HV Hordern ,AUS
1204,9,17,6,6,0,0,6,1 (1ct 0st),0.352,2016,2019,AS Joseph ,WI
1205,4,6,6,6,0,0,6,2 (2ct 0st),1.0,1984,1988,SMS Kaluperuma ,SL
1206,8,15,6,6,0,0,6,2 (2ct 0st),0.4,2006,2009,CK Kapugedera ,SL
1207,3,6,6,6,0,0,6,3 (3ct 0st),1.0,1981,1981,MF Kent ,AUS
1208,9,13,6,6,0,0,6,2 (2ct 0st),0.461,1924,1926,R Kilner ,ENG
1209,8,15,6,6,0,0,6,2 (2ct 0st),0.4,1933,1946,James Langridge ,ENG
1210,15,26,6,6,0,0,6,1 (1ct 0st),0.23,1948,1951,CN McCarthy ,SA
1211,19,34,6,6,0,0,6,2 (2ct 0st),0.176,1880,1888,PS McDonnell ,AUS
1212,8,13,6,6,0,0,6,1 (1ct 0st),0.461,1995,1997,PJ Martin ,ENG
1213,24,46,6,6,0,0,6,1 (1ct 0st),0.13,1987,1995,TBA May ,AUS
1214,9,11,6,6,0,2,4,2 (2ct 0st),0.545,2000,2003,Mehrab Hossain ,BDESH
1215,18,34,6,6,0,0,6,1 (1ct 0st),0.176,1998,2001,CR Miller ,AUS
1216,5,10,6,6,0,0,6,2 (2ct 0st),0.6,1960,1961,FM Misson ,AUS
1217,10,19,6,6,0,0,6,2 (2ct 0st),0.315,1964,1969,Mohammad Ilyas ,PAK
1218,7,14,6,6,0,0,6,2 (2ct 0st),0.428,2011,2017,A Mukund ,INDIA
1219,19,34,6,6,0,0,6,1 (1ct 0st),0.176,1996,2001,AD Mullally ,ENG
1220,8,14,6,6,0,0,6,2 (2ct 0st),0.428,1994,1995,DJ Murray ,NZ
1221,10,15,6,6,0,0,6,2 (2ct 0st),0.4,2001,2004,Mushfiqur Rahman ,BDESH
1222,3,5,6,6,0,6,0,2 (2ct 0st),1.2,1989,1989,Nadeem Abbasi ,PAK
1223,6,12,6,6,0,0,6,2 (2ct 0st),0.5,2016,2017,KK Nair ,INDIA
1224,21,37,6,6,0,0,6,1 (1ct 0st),0.162,2008,2011,BP Nash ,WI
1225,2,4,6,6,0,0,6,2 (2ct 0st),1.5,1932,1937,LJ Nash ,AUS
1226,19,35,6,6,0,0,6,2 (2ct 0st),0.171,1997,2001,SB O'Connor ,NZ
1227,14,22,6,6,0,0,6,2 (2ct 0st),0.272,1930,1937,ML Page ,NZ
1228,13,25,6,6,0,0,6,1 (1ct 0st),0.24,1953,1957,BH Pairaudeau ,WI
1229,11,20,6,6,0,0,6,1 (1ct 0st),0.3,1963,1965,JT Partridge ,SA
1230,13,25,6,6,0,0,6,2 (2ct 0st),0.24,2006,2011,MM Patel ,INDIA
1231,2,4,6,6,0,0,6,2 (2ct 0st),1.5,2019,2019,KR Patterson ,AUS
1232,8,16,6,6,0,0,6,2 (2ct 0st),0.375,1963,1967,DB Pithey ,SA
1233,33,59,6,6,0,0,6,1 (1ct 0st),0.1009999999999999,1996,2001,BKV Prasad ,INDIA
1234,25,47,6,6,0,0,6,2 (2ct 0st),0.127,2008,2015,KTGD Prasad ,SL
1235,28,52,6,6,0,0,6,1 (1ct 0st),0.115,1990,2001,SLV Raju ,INDIA
1236,11,21,6,6,0,0,6,2 (2ct 0st),0.285,1988,1997,WV Raman ,INDIA
1237,18,30,6,6,0,0,6,1 (1ct 0st),0.2,1988,1993,CPH Ramanayake ,SL
1238,6,12,6,6,0,0,6,2 (2ct 0st),0.5,1997,2009,FL Reifer ,WI
1239,34,65,6,6,0,0,6,1 (1ct 0st),0.092,1956,1963,PE Richardson ,ENG
1240,11,19,6,6,0,0,6,1 (1ct 0st),0.315,1947,1952,JDB Robertson ,ENG
1241,11,21,6,6,0,0,6,1 (1ct 0st),0.285,2016,2018,PADLR Sandakan ,SL
1242,8,13,6,6,0,0,6,2 (2ct 0st),0.461,1978,1979,S Shivnarine ,WI
1243,4,8,6,6,0,0,6,3 (3ct 0st),0.75,1935,1937,JM Sims ,ENG
1244,14,25,6,6,0,0,6,1 (1ct 0st),0.24,2006,2011,RP Singh ,INDIA
1245,8,16,6,6,0,0,6,2 (2ct 0st),0.375,1962,1964,MJ Stewart ,ENG
1246,16,29,6,6,0,0,6,1 (1ct 0st),0.206,1888,1898,AE Stoddart ,ENG
1247,21,29,6,6,0,0,6,1 (1ct 0st),0.206,2002,2005,Tapash Baisya ,BDESH
1248,9,16,6,6,0,0,6,2 (2ct 0st),0.375,1913,1921,Lord Tennyson ,ENG
1249,3,5,6,6,0,6,0,3 (3ct 0st),1.2,2004,2004,TL Tsolekile ,SA
1250,20,39,6,6,0,0,6,1 (1ct 0st),0.153,2001,2008,MG Vandort ,SL
1251,12,20,6,6,0,0,6,1 (1ct 0st),0.3,2014,2016,S van Zyl ,SA
1252,9,14,6,6,0,0,6,1 (1ct 0st),0.428,2002,2014,MA Vermeulen ,ZIM
1253,11,21,6,6,0,0,6,2 (2ct 0st),0.285,1933,1934,CF Walters ,ENG
1254,15,29,6,6,0,0,6,1 (1ct 0st),0.206,1921,1931,JC White ,ENG
1255,2,4,6,6,0,6,0,3 (3ct 0st),1.5,2018,2019,GC Wilson ,IRE
1256,12,23,6,6,0,0,6,2 (2ct 0st),0.26,1972,1978,B Wood ,ENG
1257,3,6,6,5,1,5,0,2 (2ct 0st),1.0,1924,1924,GEC Wood ,ENG
1258,2,4,6,6,0,6,0,2 (2ct 0st),1.5,1907,1908,RA Young ,ENG
1259,17,25,5,5,0,0,5,2 (2ct 0st),0.2,2002,2006,Alok Kapali ,BDESH
1260,13,16,5,5,0,0,5,3 (3ct 0st),0.312,2000,2002,Aminul Islam ,BDESH
1261,16,29,5,5,0,0,5,1 (1ct 0st),0.172,1969,1977,Asif Masood ,PAK
1262,1,2,5,5,0,5,0,3 (3ct 0st),2.5,2000,2000,Atiq-uz-Zaman ,PAK
1263,9,14,5,5,0,0,5,1 (1ct 0st),0.357,1930,1939,XC Balaskas ,SA
1264,4,6,5,3,2,3,0,3 (2ct 1st),0.833,1938,1938,BA Barnett ,AUS
1265,3,5,5,5,0,0,5,1 (1ct 0st),1.0,1984,1985,MJ Bennett ,AUS
1266,10,20,5,5,0,0,5,3 (3ct 0st),0.25,1910,1914,MC Bird ,ENG
1267,19,28,5,5,0,0,5,1 (1ct 0st),0.178,1953,1964,RW Blair ,NZ
1268,9,14,5,5,0,0,5,2 (2ct 0st),0.357,1930,1932,RC Blunt ,NZ
1269,21,41,5,5,0,0,5,1 (1ct 0st),0.121,1971,1976,KD Boyce ,WI
1270,15,25,5,5,0,0,5,2 (2ct 0st),0.2,1983,1989,NGB Cook ,ENG
1271,2,4,5,5,0,0,5,2 (2ct 0st),1.25,2019,2019,RRS Cornwall ,WI
1272,6,12,5,5,0,0,5,2 (2ct 0st),0.416,1984,1988,CS Cowdrey ,ENG
1273,15,26,5,5,0,0,5,1 (1ct 0st),0.192,1994,2002,CE Cuffy ,WI
1274,7,11,5,5,0,0,5,3 (3ct 0st),0.4539999999999999,1930,1932,SH Curnow ,SA
1275,5,7,5,5,0,0,5,3 (3ct 0st),0.7140000000000001,1930,1935,OC da Costa ,WI
1276,15,26,5,5,0,0,5,2 (2ct 0st),0.192,1929,1939,EL Dalton ,SA
1277,14,25,5,5,0,0,5,2 (2ct 0st),0.2,1978,1979,WM Darling ,AUS
1278,11,21,5,5,0,0,5,1 (1ct 0st),0.238,2019,2019,JL Denly ,ENG
1279,3,4,5,4,1,4,0,2 (2ct 0st),1.25,1993,1993,AM de Silva ,SL
1280,12,19,5,5,0,0,5,2 (2ct 0st),0.263,1982,1984,DS de Silva ,SL
1281,8,14,5,5,0,0,5,2 (2ct 0st),0.357,1997,1999,KSC de Silva ,SL
1282,5,7,5,5,0,0,5,2 (2ct 0st),0.7140000000000001,1951,1952,RV Divecha ,INDIA
1283,6,11,5,5,0,0,5,2 (2ct 0st),0.4539999999999999,2009,2010,TM Dowlin ,WI
1284,5,8,5,5,0,1,4,2 (2ct 0st),0.625,1897,1898,NF Druce ,ENG
1285,7,14,5,5,0,0,5,1 (1ct 0st),0.357,1993,2000,CE Eksteen ,SA
1286,19,36,5,5,0,0,5,1 (1ct 0st),0.138,2011,2016,RMS Eranga ,SL
1287,6,10,5,5,0,0,5,2 (2ct 0st),0.5,1881,1886,E Evans ,AUS
1288,5,10,5,5,0,0,5,2 (2ct 0st),0.5,1936,1939,AE Fagg ,ENG
1289,28,53,5,5,0,0,5,1 (1ct 0st),0.094,2011,2017,N Pradeep ,SL
1290,5,9,5,5,0,0,5,2 (2ct 0st),0.555,1894,1895,FGJ Ford ,ENG
1291,5,10,5,5,0,0,5,3 (3ct 0st),0.5,1922,1923,CM Francois ,SA
1292,11,21,5,5,0,0,5,1 (1ct 0st),0.238,1968,1970,EW Freeman ,AUS
1293,11,17,5,5,0,0,5,1 (1ct 0st),0.294,1952,1961,DK Gaekwad ,INDIA
1294,2,4,5,5,0,5,0,3 (3ct 0st),1.25,1970,1970,D Gamsy ,SA
1295,6,10,5,5,0,0,5,2 (2ct 0st),0.5,1978,1979,AE Greenidge ,WI
1296,14,24,5,5,0,0,5,1 (1ct 0st),0.208,1997,2000,AFG Griffith ,WI
1297,3,6,5,5,0,5,0,3 (3ct 0st),0.833,1948,1949,SC Griffith ,ENG
1298,11,21,5,5,0,0,5,2 (2ct 0st),0.238,1887,1899,W Gunn ,ENG
1299,1,2,5,5,0,5,0,3 (3ct 0st),2.5,2019,2019,JN Hamilton ,WI
1300,9,15,5,5,0,0,5,3 (3ct 0st),0.3329999999999999,1992,1994,BR Hartland ,NZ
1301,7,13,5,5,0,0,5,2 (2ct 0st),0.384,1996,2005,Hasan Raza ,PAK
1302,12,23,5,5,0,0,5,1 (1ct 0st),0.217,1902,1911,CMH Hathorn ,SA
1303,16,28,5,5,0,0,5,1 (1ct 0st),0.178,1982,1991,EE Hemmings ,ENG
1304,11,21,5,5,0,0,5,2 (2ct 0st),0.238,2015,2019,MJ Henry ,NZ
1305,17,31,5,5,0,0,5,1 (1ct 0st),0.161,1988,1996,ND Hirwani ,INDIA
1306,11,18,5,5,0,0,5,2 (2ct 0st),0.2769999999999999,1984,1986,RG Holland ,AUS
1307,9,13,5,5,0,0,5,2 (2ct 0st),0.384,2001,2005,DT Hondo ,ZIM
1308,3,6,5,5,0,5,0,3 (3ct 0st),0.833,1930,1930,EAC Hunte ,WI
1309,8,13,5,5,0,2,3,2 (2ct 0st),0.384,1959,1962,Ijaz Butt ,PAK
1310,1,2,5,4,1,4,0,3 (2ct 1st),2.5,2019,2019,Ikram Alikhil ,AFG
1311,9,14,5,5,0,0,5,2 (2ct 0st),0.357,1991,1995,RK Illingworth ,ENG
1312,15,25,5,5,0,0,5,2 (2ct 0st),0.2,1992,2000,A Jadeja ,INDIA
1313,9,18,5,5,0,0,5,2 (2ct 0st),0.2769999999999999,1970,1975,TJ Jenner ,AUS
1314,6,9,5,5,0,0,5,2 (2ct 0st),0.555,1912,1912,CB Jennings ,AUS
1315,8,15,5,5,0,0,5,1 (1ct 0st),0.3329999999999999,1921,1928,VWC Jupp ,ENG
1316,5,9,5,5,0,0,5,2 (2ct 0st),0.555,1922,1923,AS Kennedy ,ENG
1317,8,15,5,5,0,0,5,2 (2ct 0st),0.3329999999999999,1951,1955,D Kenyon ,ENG
1318,9,17,5,5,0,0,5,2 (2ct 0st),0.294,1976,1980,CL King ,WI
1319,14,26,5,5,0,0,5,2 (2ct 0st),0.192,1953,1956,FM King ,WI
1320,4,7,5,5,0,0,5,3 (3ct 0st),0.7140000000000001,1986,1987,R Lamba ,INDIA
1321,8,15,5,5,0,0,5,2 (2ct 0st),0.3329999999999999,1994,1996,GR Larsen ,NZ
1322,10,20,5,5,0,0,5,2 (2ct 0st),0.25,1962,1965,JDF Larter ,ENG
1323,4,8,5,5,0,0,5,2 (2ct 0st),0.625,1992,1993,RT Latham ,NZ
1324,10,19,5,5,0,0,5,1 (1ct 0st),0.263,2018,2019,MJ Leach ,ENG
1325,3,6,5,4,1,4,0,2 (1ct 1st),0.833,1947,1947,JD Lindsay ,SA
1326,7,12,5,5,0,0,5,2 (2ct 0st),0.416,1951,1955,FA Lowson ,ENG
1327,8,14,5,5,0,0,5,1 (1ct 0st),0.357,1923,1933,GG Macaulay ,ENG
1328,4,8,5,5,0,0,5,2 (2ct 0st),0.625,1980,1984,PE McEwan ,NZ
1329,19,33,5,5,0,0,5,1 (1ct 0st),0.151,1998,2001,NAM McLean ,WI
1330,13,25,5,5,0,0,5,1 (1ct 0st),0.2,1958,1966,EDAS McMorris ,WI
1331,27,45,5,5,0,0,5,1 (1ct 0st),0.111,1952,1962,Mahmood Hussain ,PAK
1332,7,13,5,5,0,0,5,1 (1ct 0st),0.384,2005,2008,JAH Marshall ,NZ
1333,8,16,5,5,0,0,5,3 (3ct 0st),0.312,1960,1967,JW Martin ,AUS
1334,10,17,5,5,0,0,5,1 (1ct 0st),0.294,1933,1939,EA Martindale ,WI
1335,9,17,5,5,0,0,5,1 (1ct 0st),0.294,1881,1885,HH Massie ,AUS
1336,7,12,5,5,0,0,5,2 (2ct 0st),0.416,2013,2017,GJ Maxwell ,AUS
1337,6,12,5,5,0,0,5,2 (2ct 0st),0.416,1958,1959,CA Milton ,ENG
1338,17,31,5,5,0,0,5,2 (2ct 0st),0.161,2017,2019,Mohammad Abbas ,PAK
1339,36,69,5,5,0,0,5,1 (1ct 0st),0.072,2009,2019,Mohammad Amir ,PAK
1340,10,12,5,5,0,0,5,2 (2ct 0st),0.416,2001,2007,Mohammad Sharif ,BDESH
1341,4,8,5,5,0,0,5,2 (2ct 0st),0.625,2016,2017,CH Morris ,SA
1342,17,30,5,5,0,0,5,1 (1ct 0st),0.166,1999,2004,A Nehra ,INDIA
1343,5,10,5,5,0,0,5,1 (1ct 0st),0.5,1977,1978,AD Ogilvie ,AUS
1344,1,2,5,4,1,4,0,3 (2ct 1st),2.5,2015,2015,NV Ojha ,INDIA
1345,4,7,5,5,0,0,5,2 (2ct 0st),0.7140000000000001,1935,1935,GAE Paine ,ENG
1346,7,13,5,5,0,0,5,2 (2ct 0st),0.384,2018,2019,AY Patel ,NZ
1347,28,54,5,5,0,0,5,1 (1ct 0st),0.092,1986,1992,BP Patterson ,WI
1348,20,38,5,5,0,0,5,1 (1ct 0st),0.131,2011,2019,JL Pattinson ,AUS
1349,1,2,5,5,0,5,0,3 (3ct 0st),2.5,1986,1986,TRO Payne ,WI
1350,13,21,5,5,0,0,5,1 (1ct 0st),0.238,1927,1931,IAR Peebles ,ENG
1351,16,24,5,5,0,0,5,2 (2ct 0st),0.208,1910,1924,SJ Pegler ,SA
1352,9,15,5,5,0,0,5,2 (2ct 0st),0.3329999999999999,1978,1979,N Phillip ,WI
1353,8,15,5,5,0,0,5,2 (2ct 0st),0.3329999999999999,1965,1966,PI Philpott ,AUS
1354,9,16,5,5,0,0,5,2 (2ct 0st),0.312,2014,2019,DL Piedt ,SA
1355,15,24,5,5,0,0,5,1 (1ct 0st),0.208,1993,1997,BA Pocock ,NZ
1356,4,7,5,5,0,1,4,2 (2ct 0st),0.7140000000000001,2018,2019,OJ Pope ,ENG
1357,5,9,5,5,0,0,5,1 (1ct 0st),0.555,1955,1955,PH Punjabi ,INDIA
1358,2,4,5,5,0,0,5,2 (2ct 0st),1.25,2012,2012,RJ Quiney ,AUS
1359,12,19,5,5,0,0,5,2 (2ct 0st),0.263,1949,1955,GO Rabone ,NZ
1360,8,12,5,5,0,0,5,2 (2ct 0st),0.416,2008,2013,AJ Redmond ,NZ
1361,27,46,5,5,0,0,5,1 (1ct 0st),0.108,1985,1992,BA Reid ,AUS
1362,14,25,5,5,0,0,5,1 (1ct 0st),0.2,1893,1898,T Richardson ,ENG
1363,8,16,5,5,0,0,5,1 (1ct 0st),0.312,1931,1937,KE Rigg ,AUS
1364,13,26,5,5,0,0,5,1 (1ct 0st),0.192,1948,1953,DT Ring ,AUS
1365,16,23,5,5,0,0,5,1 (1ct 0st),0.217,1928,1935,CA Roach ,WI
1366,9,17,5,5,0,0,5,1 (1ct 0st),0.294,2010,2014,Robiul Islam ,BDESH
1367,7,14,5,5,0,0,5,1 (1ct 0st),0.357,2014,2014,SD Robson ,ENG
1368,4,8,5,5,0,5,0,2 (2ct 0st),0.625,2015,2016,L Ronchi ,NZ
1369,15,27,5,5,0,0,5,2 (2ct 0st),0.185,1992,2000,IDK Salisbury ,ENG
1370,7,9,5,5,0,0,5,2 (2ct 0st),0.555,1993,1995,DP Samaraweera ,SL
1371,14,27,5,5,0,0,5,2 (2ct 0st),0.185,1902,1908,JV Saunders ,AUS
1372,5,9,5,5,0,0,5,2 (2ct 0st),0.555,1964,1969,Shafqat Rana ,PAK
1373,15,29,5,5,0,0,5,2 (2ct 0st),0.172,1996,2007,Shahid Nazir ,PAK
1374,22,37,5,5,0,0,5,1 (1ct 0st),0.135,2001,2010,RJ Sidebottom ,ENG
1375,8,15,5,5,0,0,5,1 (1ct 0st),0.3329999999999999,2009,2011,LMP Simmons ,WI
1376,27,51,5,5,0,0,5,2 (2ct 0st),0.098,1948,1955,RT Simpson ,ENG
1377,1,2,5,5,0,0,5,3 (3ct 0st),2.5,1998,1998,RR Singh ,INDIA
1378,8,16,5,5,0,0,5,2 (2ct 0st),0.312,1983,1986,CL Smith ,ENG
1379,5,10,5,4,1,1,3,3 (3ct 0st),0.5,1960,1962,CW Smith ,WI
1380,3,6,5,5,0,0,5,2 (2ct 0st),0.833,2003,2003,ET Smith ,ENG
1381,10,18,5,5,0,0,5,1 (1ct 0st),0.2769999999999999,2012,2014,Sohag Gazi ,BDESH
1382,27,50,5,5,0,0,5,2 (2ct 0st),0.1,2006,2011,S Sreesanth ,INDIA
1383,13,24,5,5,0,0,5,1 (1ct 0st),0.208,1880,1888,AG Steel ,ENG
1384,5,10,5,5,0,0,5,2 (2ct 0st),0.5,1882,1883,CT Studd ,ENG
1385,13,23,5,5,0,0,5,1 (1ct 0st),0.217,1958,1961,R Subba Row ,ENG
1386,20,35,5,5,0,0,5,2 (2ct 0st),0.142,1993,1998,PL Symcox ,SA
1387,6,12,5,5,0,0,5,2 (2ct 0st),0.416,1909,1910,GJ Thompson ,ENG
1388,4,8,5,5,0,0,5,1 (1ct 0st),0.625,1977,1977,RW Tolchard ,ENG
1389,16,28,5,5,0,0,5,1 (1ct 0st),0.178,1995,1999,RG Twose ,NZ
1390,27,46,5,5,0,0,5,1 (1ct 0st),0.108,1930,1949,KG Viljoen ,SA
1391,27,52,5,5,0,0,5,1 (1ct 0st),0.096,2010,2018,Wahab Riaz ,PAK
1392,3,6,5,5,0,0,5,2 (2ct 0st),0.833,1960,1960,PM Walker ,ENG
1393,13,20,5,5,0,0,5,1 (1ct 0st),0.25,1937,1953,WM Wallace ,NZ
1394,20,37,5,5,0,0,5,1 (1ct 0st),0.135,1952,1959,Wazir Mohammad ,PAK
1395,21,36,5,5,0,0,5,1 (1ct 0st),0.138,2007,2014,UWMBCA Welegedara ,SL
1396,6,10,5,5,0,0,5,2 (2ct 0st),0.5,1981,1987,DM Wellham ,AUS
1397,7,12,5,5,0,0,5,2 (2ct 0st),0.416,1978,1979,AB Williams ,WI
1398,13,25,5,5,0,0,5,1 (1ct 0st),0.2,2015,2019,MA Wood ,ENG
1399,6,10,5,5,0,0,5,3 (3ct 0st),0.5,1888,1896,SMJ Woods ,AUS
1400,8,14,5,5,0,0,5,1 (1ct 0st),0.357,1947,1949,JA Young ,ENG
1401,9,16,5,5,0,0,5,1 (1ct 0st),0.312,1990,1995,Zahid Fazal ,PAK
1402,9,16,5,5,0,0,5,1 (1ct 0st),0.312,1952,1956,Zulfiqar Ahmed ,PAK
1403,11,21,4,4,0,0,4,1 (1ct 0st),0.19,2013,2017,KJ Abbott ,SA
1404,13,21,4,4,0,0,4,1 (1ct 0st),0.19,2006,2018,Abdur Razzak ,BDESH
1405,4,8,4,4,0,0,4,2 (2ct 0st),0.5,1928,1932,EL a'Beckett ,AUS
1406,26,48,4,4,0,0,4,1 (1ct 0st),0.083,1953,1962,NAT Adcock ,SA
1407,13,24,4,4,0,0,4,1 (1ct 0st),0.166,1981,1985,PJW Allott ,ENG
1408,10,17,4,4,0,0,4,2 (2ct 0st),0.235,1976,1978,S Amarnath ,INDIA
1409,18,27,4,4,0,0,4,1 (1ct 0st),0.148,1986,1998,SD Anurasiri ,SL
1410,9,18,4,4,0,0,4,2 (2ct 0st),0.222,1954,1956,R Appleyard ,ENG
1411,4,6,4,4,0,0,4,2 (2ct 0st),0.6659999999999999,1992,1993,KJ Arnott ,ZIM
1412,8,15,4,4,0,0,4,1 (1ct 0st),0.266,1998,2006,HMCM Bandara ,SL
1413,12,22,4,4,0,0,4,1 (1ct 0st),0.181,2001,2002,SB Bangar ,INDIA
1414,7,11,4,4,0,0,4,2 (2ct 0st),0.363,1961,1963,PT Barton ,NZ
1415,3,6,4,4,0,0,4,2 (2ct 0st),0.6659999999999999,1892,1892,G Bean ,ENG
1416,6,9,4,4,0,0,4,1 (1ct 0st),0.444,2014,2015,STR Binny ,INDIA
1417,4,5,4,4,0,0,4,2 (2ct 0st),0.8,1930,1931,LS Birkett ,WI
1418,10,18,4,4,0,0,4,1 (1ct 0st),0.222,1992,1999,EA Brandes ,ZIM
1419,8,14,4,4,0,0,4,1 (1ct 0st),0.285,2002,2004,IG Butler ,NZ
1420,4,8,4,4,0,0,4,1 (1ct 0st),0.5,1959,1967,MR Bynoe ,WI
1421,11,18,4,4,0,0,4,1 (1ct 0st),0.222,1968,1971,GS Camacho ,WI
1422,6,12,4,4,0,0,4,1 (1ct 0st),0.3329999999999999,2019,2019,JD Campbell ,WI
1423,8,14,4,4,0,0,4,1 (1ct 0st),0.285,2015,2019,PVD Chameera ,SL
1424,4,8,4,4,0,0,4,1 (1ct 0st),0.5,2008,2008,S Chattergoon ,WI
1425,24,48,4,4,0,0,4,1 (1ct 0st),0.083,2006,2009,SR Clark ,AUS
1426,2,3,4,4,0,4,0,2 (2ct 0st),1.3330000000000002,1955,1955,IA Colquhoun ,NZ
1427,10,20,4,4,0,0,4,1 (1ct 0st),0.2,1976,1984,WW Daniel ,WI
1428,15,27,4,4,0,0,4,1 (1ct 0st),0.148,1968,1973,CA Davis ,WI
1429,5,9,4,4,0,0,4,1 (1ct 0st),0.444,1994,1997,HT Davis ,NZ
1430,10,16,4,4,0,0,4,1 (1ct 0st),0.25,1985,1991,EAR de Silva ,SL
1431,4,8,4,4,0,0,4,2 (2ct 0st),0.5,2014,2014,AJ Doolan ,AUS
1432,5,9,4,4,0,0,4,1 (1ct 0st),0.444,2001,2002,CJ Drum ,NZ
1433,8,13,4,4,0,0,4,1 (1ct 0st),0.307,1996,1998,MA Ealham ,ENG
1434,3,6,4,4,0,0,4,2 (2ct 0st),0.6659999999999999,1961,1962,MK Elgie ,SA
1435,10,15,4,4,0,0,4,2 (2ct 0st),0.266,1987,1993,NH Fairbrother ,ENG
1436,9,17,4,4,0,0,4,2 (2ct 0st),0.235,2001,2002,TCB Fernando ,SL
1437,9,16,4,4,0,0,4,1 (1ct 0st),0.25,1887,1892,JJ Ferris ,AUS
1438,6,12,4,4,0,0,4,2 (2ct 0st),0.3329999999999999,1904,1908,A Fielder ,ENG
1439,12,23,4,4,0,0,4,1 (1ct 0st),0.173,1924,1929,AP Freeman ,ENG
1440,3,5,4,4,0,0,4,2 (2ct 0st),0.8,2012,2012,AB Fudadin ,WI
1441,1,2,4,3,1,3,0,3 (2ct 1st),2.0,1894,1894,LH Gay ,ENG
1442,8,12,4,4,0,0,4,1 (1ct 0st),0.3329999999999999,1953,1959,JM Ghorpade ,INDIA
1443,8,14,4,3,1,3,0,2 (1ct 1st),0.285,1938,1946,PA Gibb ,ENG
1444,13,23,4,4,0,0,4,1 (1ct 0st),0.173,1957,1959,R Gilchrist ,WI
1445,13,18,4,4,0,0,4,1 (1ct 0st),0.222,1928,1933,HC Griffith ,WI
1446,5,10,4,4,0,0,4,2 (2ct 0st),0.4,1921,1930,NE Haig ,ENG
1447,7,14,4,4,0,0,4,1 (1ct 0st),0.285,1923,1931,AE Hall ,SA
1448,3,6,4,4,0,0,4,3 (3ct 0st),0.6659999999999999,2016,2016,H Hameed ,ENG
1449,9,17,4,4,0,0,4,1 (1ct 0st),0.235,2017,2019,Hasan Ali ,PAK
1450,16,31,4,4,0,0,4,1 (1ct 0st),0.129,1999,2004,M Hayward ,SA
1451,9,15,4,4,0,0,4,1 (1ct 0st),0.266,1907,1912,GR Hazlitt ,AUS
1452,12,22,4,4,0,0,4,2 (2ct 0st),0.181,1892,1899,JT Hearne ,ENG
1453,15,27,4,4,0,0,4,1 (1ct 0st),0.148,1965,1968,K Higgs ,ENG
1454,7,12,4,4,0,0,4,1 (1ct 0st),0.3329999999999999,1911,1921,JW Hitch ,ENG
1455,4,6,4,4,0,0,4,1 (1ct 0st),0.6659999999999999,1997,1998,AJ Hollioake ,ENG
1456,5,9,4,4,0,0,4,2 (2ct 0st),0.444,1935,1935,ERT Holmes ,ENG
1457,4,7,4,4,0,0,4,2 (2ct 0st),0.5710000000000001,1951,1952,ND Howard ,ENG
1458,2,4,4,4,0,0,4,2 (2ct 0st),1.0,2019,2019,Ibrahim Zadran ,AFG
1459,3,6,4,4,0,0,4,2 (2ct 0st),0.6659999999999999,2019,2019,Ihsanullah ,AFG
1460,8,14,4,4,0,0,4,1 (1ct 0st),0.285,1999,2002,Imran Nazir ,PAK
1461,6,12,4,4,0,0,4,2 (2ct 0st),0.3329999999999999,1968,1972,RJ Inverarity ,AUS
1462,4,7,4,4,0,0,4,3 (3ct 0st),0.5710000000000001,1932,1936,M Jahangir Khan ,INDIA
1463,9,18,4,4,0,0,4,1 (1ct 0st),0.222,1948,1952,RO Jenkins ,ENG
1464,15,27,4,4,0,0,4,1 (1ct 0st),0.148,1964,1968,IJ Jones ,ENG
1465,9,18,4,4,0,0,4,1 (1ct 0st),0.222,1948,1951,PEW Jones ,WI
1466,18,35,4,4,0,0,4,1 (1ct 0st),0.114,2002,2005,SP Jones ,ENG
1467,7,14,4,4,0,0,4,1 (1ct 0st),0.285,1993,1995,BP Julian ,AUS
1468,12,22,4,4,0,0,4,2 (2ct 0st),0.181,1972,1979,RR Jumadeen ,WI
1469,22,43,4,4,0,0,4,2 (2ct 0st),0.093,2011,2015,Junaid Khan ,PAK
1470,7,10,4,4,0,0,4,2 (2ct 0st),0.4,1931,1937,JL Kerr ,NZ
1471,13,22,4,4,0,0,4,2 (2ct 0st),0.181,1952,1958,Khan Mohammad ,PAK
1472,1,1,4,3,1,3,0,4 (3ct 1st),4.0,2019,2019,H Klaasen ,SA
1473,2,4,4,4,0,0,4,3 (3ct 0st),1.0,2008,2008,JJ Krejza ,AUS
1474,14,25,4,4,0,0,4,1 (1ct 0st),0.16,1955,1964,AG Kripal Singh ,INDIA
1475,19,32,4,4,0,0,4,1 (1ct 0st),0.125,2016,2019,CBRLS Kumara ,SL
1476,4,8,4,4,0,0,4,2 (2ct 0st),0.5,1960,1966,PD Lashley ,WI
1477,12,20,4,4,0,0,4,2 (2ct 0st),0.2,1893,1902,WH Lockwood ,ENG
1478,2,4,4,4,0,0,4,4 (4ct 0st),1.0,1954,1954,JE McConnon ,ENG
1479,5,10,4,4,0,0,4,2 (2ct 0st),0.4,1895,1898,TR McKibbin ,AUS
1480,3,5,4,4,0,0,4,1 (1ct 0st),0.8,1999,2000,DL Maddy ,ENG
1481,17,22,4,4,0,0,4,1 (1ct 0st),0.181,2001,2004,Manjural Islam ,BDESH
1482,5,9,4,4,0,0,4,1 (1ct 0st),0.444,1922,1923,FT Mann ,ENG
1483,18,33,4,4,0,0,4,2 (2ct 0st),0.121,1992,1995,CR Matthews ,SA
1484,17,31,4,4,0,0,4,1 (1ct 0st),0.129,1911,1928,CP Mead ,ENG
1485,7,12,4,4,0,0,4,2 (2ct 0st),0.3329999999999999,1950,1953,MG Melle ,SA
1486,19,33,4,4,0,0,4,1 (1ct 0st),0.121,2004,2009,KD Mills ,NZ
1487,9,15,4,4,0,0,4,1 (1ct 0st),0.266,1995,2001,Mohammad Akram ,PAK
1488,14,23,4,4,0,0,4,1 (1ct 0st),0.173,1969,1983,Mohammad Nazir ,PAK
1489,2,2,4,3,1,3,0,2 (2ct 0st),2.0,2003,2003,Mohammad Salim ,BDESH
1490,9,15,4,4,0,0,4,1 (1ct 0st),0.266,1984,1994,Mohsin Kamal ,PAK
1491,4,7,4,4,0,1,3,2 (2ct 0st),0.5710000000000001,1906,1906,LJ Moon ,ENG
1492,4,8,4,4,0,0,4,2 (2ct 0st),0.5,1880,1883,F Morley ,ENG
1493,15,24,4,4,0,0,4,1 (1ct 0st),0.166,2005,2017,CB Mpofu ,ZIM
1494,8,11,4,4,0,0,4,2 (2ct 0st),0.363,2000,2002,Naimur Rahman ,BDESH
1495,7,13,4,4,0,0,4,1 (1ct 0st),0.307,1932,1936,CK Nayudu ,INDIA
1496,10,17,4,4,0,0,4,2 (2ct 0st),0.235,2000,2005,ML Nkala ,ZIM
1497,5,9,4,4,0,0,4,1 (1ct 0st),0.444,1884,1896,TC O'Brien ,ENG
1498,6,10,4,4,0,0,4,2 (2ct 0st),0.4,1985,1985,SP O'Donnell ,AUS
1499,7,13,4,4,0,0,4,2 (2ct 0st),0.307,1960,1961,S O'Linn ,SA
1500,5,9,4,4,0,0,4,2 (2ct 0st),0.444,1929,1929,HGO Owen-Smith ,SA
1501,7,14,4,4,0,0,4,1 (1ct 0st),0.285,1928,1931,RK Oxenham ,AUS
1502,12,21,4,4,0,0,4,1 (1ct 0st),0.19,1978,1980,DR Parry ,WI
1503,1,2,4,3,1,3,0,4 (3ct 1st),2.0,1955,1956,CT Patankar ,INDIA
1504,10,20,4,4,0,0,4,1 (1ct 0st),0.2,1920,1921,CE Pellew ,AUS
1505,6,12,4,4,0,0,4,2 (2ct 0st),0.3329999999999999,1976,1977,PJ Petherick ,NZ
1506,8,10,4,4,0,0,4,1 (1ct 0st),0.4,1958,1963,WR Playle ,NZ
1507,22,37,4,4,0,0,4,2 (2ct 0st),0.108,1999,2013,RW Price ,ZIM
1508,7,14,4,4,0,0,4,2 (2ct 0st),0.285,1967,1970,MJ Procter ,SA
1509,7,14,4,4,0,0,4,2 (2ct 0st),0.285,1899,1902,WG Quaife ,ENG
1510,8,15,4,4,0,0,4,1 (1ct 0st),0.266,1978,1978,CT Radley ,ENG
1511,1,2,4,0,4,0,0,2 (0ct 2st),2.0,1952,1952,V Rajindernath ,INDIA
1512,7,12,4,4,0,0,4,3 (3ct 0st),0.3329999999999999,2018,2019,CAK Rajitha ,SL
1513,19,36,4,4,0,0,4,1 (1ct 0st),0.111,2015,2019,AU Rashid ,ENG
1514,3,6,4,4,0,0,4,1 (1ct 0st),0.6659999999999999,2009,2010,DM Richards ,WI
1515,11,19,4,4,0,0,4,1 (1ct 0st),0.21,1981,1989,Rizwan-uz-Zaman ,PAK
1516,7,14,4,4,0,0,4,1 (1ct 0st),0.285,1976,1976,ADG Roberts ,NZ
1517,5,9,4,4,0,0,4,1 (1ct 0st),0.444,1930,1937,AW Roberts ,NZ
1518,3,5,4,4,0,0,4,1 (1ct 0st),0.8,1977,1977,RD Robinson ,AUS
1519,9,13,4,4,0,0,4,2 (2ct 0st),0.307,1977,1981,BC Rose ,ENG
1520,19,33,4,4,0,0,4,2 (2ct 0st),0.121,1997,2000,FA Rose ,WI
1521,5,8,4,4,0,0,4,2 (2ct 0st),0.5,1896,1902,GA Rowe ,SA
1522,10,18,4,4,0,0,4,2 (2ct 0st),0.222,1961,1967,WE Russell ,ENG
1523,4,7,4,4,0,0,4,2 (2ct 0st),0.5710000000000001,2017,2017,S Samarawickrama ,SL
1524,14,24,4,4,0,0,4,1 (1ct 0st),0.166,1921,1930,A Sandham ,ENG
1525,11,19,4,4,0,0,4,2 (2ct 0st),0.21,2002,2004,A Sanford ,WI
1526,30,55,4,4,0,0,4,1 (1ct 0st),0.072,1961,1972,DN Sardesai ,INDIA
1527,15,28,4,4,0,0,4,2 (2ct 0st),0.142,1881,1887,WH Scotton ,ENG
1528,3,6,4,4,0,0,4,2 (2ct 0st),0.6659999999999999,1993,1995,Shakeel Ahmed jnr ,PAK
1529,7,13,4,4,0,0,4,2 (2ct 0st),0.307,1877,1882,A Shaw ,ENG
1530,5,10,4,4,0,0,4,2 (2ct 0st),0.4,1969,1971,JN Shepherd ,WI
1531,3,5,4,4,0,0,4,2 (2ct 0st),0.8,1936,1937,MW Sievers ,AUS
1532,14,23,4,4,0,0,4,1 (1ct 0st),0.173,1979,1990,PR Sleep ,AUS
1533,10,18,4,4,0,0,4,1 (1ct 0st),0.222,1905,1912,RH Spooner ,ENG
1534,3,6,4,4,0,0,4,2 (2ct 0st),0.6659999999999999,2018,2019,PR Stirling ,IRE
1535,11,20,4,4,0,0,4,2 (2ct 0st),0.2,1993,1999,PM Such ,ENG
1536,11,17,4,4,0,0,4,2 (2ct 0st),0.235,1958,1961,Surendranath ,INDIA
1537,10,16,4,4,0,0,4,1 (1ct 0st),0.25,1972,1979,Talat Ali ,PAK
1538,7,14,4,4,0,0,4,1 (1ct 0st),0.285,1998,2004,DJ Terbrugge ,SA
1539,12,24,4,4,0,0,4,1 (1ct 0st),0.166,1946,1948,ERH Toshack ,AUS
1540,12,24,4,4,0,0,4,1 (1ct 0st),0.166,2007,2013,CT Tremlett ,ENG
1541,5,10,4,4,0,0,4,3 (3ct 0st),0.4,1895,1899,AE Trott ,AUS
1542,17,32,4,4,0,0,4,1 (1ct 0st),0.125,1954,1959,FH Tyson ,ENG
1543,6,9,4,4,0,0,4,2 (2ct 0st),0.444,1992,1997,JTC Vaughan ,NZ
1544,7,11,4,4,0,0,4,1 (1ct 0st),0.363,1931,1937,HG Vivian ,NZ
1545,10,15,4,4,0,0,4,1 (1ct 0st),0.266,1935,1936,HF Wade ,SA
1546,15,26,4,4,0,0,4,1 (1ct 0st),0.153,1986,1993,W Watson ,NZ
1547,14,25,4,4,0,0,4,1 (1ct 0st),0.16,1909,1912,WJ Whitty ,AUS
1548,6,10,4,4,0,0,4,2 (2ct 0st),0.4,1979,1980,JM Wiener ,AUS
1549,4,8,4,4,0,0,4,2 (2ct 0st),0.5,2003,2004,BA Williams ,AUS
1550,30,51,4,4,0,0,4,1 (1ct 0st),0.078,1997,2004,DNT Zoysa ,SL
1551,3,5,4,4,0,0,4,2 (2ct 0st),0.8,2019,2019,Zubayr Hamza ,SA
1552,16,30,4,4,0,0,4,1 (1ct 0st),0.133,1910,1921,JW Zulch ,SA
1553,15,28,4,4,0,0,4,1 (1ct 0st),0.142,2013,2016,Zulfiqar Babar ,PAK
1554,3,6,3,3,0,0,3,2 (2ct 0st),0.5,2012,2013,Abul Hasan ,BDESH
1555,6,11,3,3,0,0,3,1 (1ct 0st),0.272,1969,1971,Aftab Gul ,PAK
1556,1,2,3,3,0,0,3,2 (2ct 0st),1.5,1955,1955,Agha Saadat Ali ,PAK
1557,13,26,3,3,0,0,3,1 (1ct 0st),0.115,2013,2017,Ahmed Shehzad ,PAK
1558,8,11,3,3,0,0,3,1 (1ct 0st),0.272,2000,2003,Akram Khan ,BDESH
1559,6,9,3,3,0,0,3,1 (1ct 0st),0.3329999999999999,1930,1932,CFW Allcott ,NZ
1560,7,13,3,3,0,0,3,1 (1ct 0st),0.23,1932,1936,L Amar Singh ,INDIA
1561,2,3,3,3,0,0,3,2 (2ct 0st),1.0,1984,1984,AMJG Amerasinghe ,SL
1562,6,12,3,3,0,0,3,1 (1ct 0st),0.25,2010,2012,BJ Arnel ,NZ
1563,2,4,3,3,0,0,3,2 (2ct 0st),0.75,2009,2009,RA Austin ,WI
1564,7,14,3,3,0,0,3,1 (1ct 0st),0.214,1981,1983,KBJ Azad ,INDIA
1565,7,11,3,3,0,0,3,1 (1ct 0st),0.272,1936,1938,CL Badcock ,AUS
1566,6,12,3,3,0,0,3,2 (2ct 0st),0.25,1931,1935,AH Bakewell ,ENG
1567,3,6,3,3,0,0,3,1 (1ct 0st),0.5,2018,2019,A Balbirnie ,IRE
1568,1,2,3,3,0,0,3,2 (2ct 0st),1.5,1948,1949,SA Banerjee ,INDIA
1569,9,16,3,3,0,0,3,2 (2ct 0st),0.187,2003,2016,GJ Batty ,ENG
1570,2,3,3,3,0,0,3,1 (1ct 0st),1.0,1966,1966,GP Bilby ,NZ
1571,5,9,3,3,0,0,3,2 (2ct 0st),0.3329999999999999,1973,1974,J Birkenshaw ,ENG
1572,3,6,3,2,1,2,0,1 (1ct 0st),0.5,1899,1910,M Bisset ,SA
1573,3,6,3,3,0,2,1,1 (1ct 0st),0.5,2017,2019,TA Blundell ,NZ
1574,5,10,3,3,0,0,3,1 (1ct 0st),0.3,2006,2010,J Botha ,SA
1575,5,7,3,3,0,0,3,2 (2ct 0st),0.428,2006,2006,IDR Bradshaw ,WI
1576,2,4,3,3,0,0,3,2 (2ct 0st),0.75,1985,1985,VR Brown ,NZ
1577,12,24,3,3,0,0,3,1 (1ct 0st),0.125,2018,2019,JJ Bumrah ,INDIA
1578,3,4,3,3,0,0,3,2 (2ct 0st),0.75,1981,1981,RO Butcher ,ENG
1579,4,8,3,3,0,0,3,1 (1ct 0st),0.375,1930,1930,Hon.FSG Calthorpe ,ENG
1580,8,15,3,3,0,0,3,1 (1ct 0st),0.2,1958,1964,PR Carlstein ,SA
1581,11,16,3,3,0,0,3,1 (1ct 0st),0.187,1922,1929,AW Carr ,ENG
1582,10,17,3,3,0,0,3,1 (1ct 0st),0.176,1929,1932,JAJ Christy ,SA
1583,2,3,3,3,0,0,3,2 (2ct 0st),1.0,2005,2005,CK Coventry ,ZIM
1584,9,14,3,3,0,0,3,2 (2ct 0st),0.214,1937,1949,J Cowie ,NZ
1585,8,16,3,3,0,0,3,2 (2ct 0st),0.187,1947,1948,K Cranston ,ENG
1586,9,14,3,3,0,0,3,1 (1ct 0st),0.214,1935,1936,RJ Crisp ,SA
1587,11,20,3,3,0,0,3,1 (1ct 0st),0.15,2005,2008,CD Cumming ,NZ
1588,5,9,3,3,0,0,3,1 (1ct 0st),0.3329999999999999,1988,1989,TS Curtis ,ENG
1589,7,11,3,3,0,0,3,2 (2ct 0st),0.272,2001,2003,RKJ Dawson ,ENG
1590,3,5,3,3,0,0,3,2 (2ct 0st),0.6,1953,1953,JH de Courcy ,AUS
1591,3,6,3,3,0,0,3,2 (2ct 0st),0.5,1930,1932,GR Dickinson ,NZ
1592,2,4,3,3,0,0,3,1 (1ct 0st),0.75,1950,1950,GHG Doggart ,ENG
1593,3,6,3,3,0,0,3,1 (1ct 0st),0.5,1947,1948,B Dooland ,AUS
1594,4,8,3,3,0,0,3,1 (1ct 0st),0.375,1971,1973,UG Dowe ,WI
1595,6,10,3,3,0,0,3,2 (2ct 0st),0.3,1959,1962,A D'Souza ,PAK
1596,2,4,3,3,0,0,3,1 (1ct 0st),0.75,1957,1957,CAR Duckworth ,SA
1597,5,10,3,3,0,0,3,1 (1ct 0st),0.3,1965,1967,R Dumbrill ,SA
1598,15,27,3,3,0,0,3,1 (1ct 0st),0.111,2003,2013,Enamul Haque jnr ,BDESH
1599,3,6,3,3,0,0,3,1 (1ct 0st),0.5,2018,2019,Fakhar Zaman ,PAK
1600,3,6,3,3,0,0,3,1 (1ct 0st),0.5,2009,2009,Fawad Alam ,PAK
1601,4,7,3,3,0,0,3,1 (1ct 0st),0.428,2019,2019,BOP Fernando ,SL
1602,14,26,3,3,0,0,3,1 (1ct 0st),0.115,1969,1978,MLC Foster ,WI
1603,7,12,3,3,0,0,3,1 (1ct 0st),0.25,1953,1958,ERH Fuller ,SA
1604,4,8,3,3,0,0,3,1 (1ct 0st),0.375,1999,1999,DJ Gandhi ,INDIA
1605,3,5,3,3,0,0,3,2 (2ct 0st),0.6,1977,1978,JB Gannon ,AUS
1606,11,21,3,3,0,0,3,1 (1ct 0st),0.142,1922,1925,AER Gilligan ,ENG
1607,8,13,3,3,0,0,3,1 (1ct 0st),0.23,1930,1939,TWJ Goddard ,ENG
1608,1,2,3,3,0,0,3,2 (2ct 0st),1.5,1934,1934,MJ Gopalan ,INDIA
1609,6,11,3,3,0,0,3,1 (1ct 0st),0.272,1893,1896,H Graham ,AUS
1610,5,9,3,3,0,0,3,1 (1ct 0st),0.3329999999999999,1972,1973,GA Greenidge ,WI
1611,9,13,3,3,0,0,3,1 (1ct 0st),0.23,1946,1956,Gul Mohammad ,INDIA
1612,6,12,3,3,0,0,3,1 (1ct 0st),0.25,1901,1905,JR Gunn ,ENG
1613,7,10,3,3,0,0,3,2 (2ct 0st),0.3,1913,1924,PAM Hands ,SA
1614,2,4,3,3,0,0,3,2 (2ct 0st),0.75,1958,1958,MS Hardikar ,INDIA
1615,17,33,3,3,0,0,3,1 (1ct 0st),0.09,2004,2010,NM Hauritz ,AUS
1616,5,10,3,3,0,0,3,2 (2ct 0st),0.3,1896,1899,Lord Hawke ,ENG
1617,15,20,3,3,0,0,3,2 (2ct 0st),0.15,1951,1958,JA Hayes ,NZ
1618,6,9,3,3,0,0,3,1 (1ct 0st),0.3329999999999999,1889,1896,F Hearne ,ENG
1619,3,5,3,3,0,0,3,3 (3ct 0st),0.6,1922,1924,GAL Hearne ,SA
1620,2,4,3,3,0,0,3,1 (1ct 0st),0.75,1896,1896,C Heseltine ,ENG
1621,22,39,3,3,0,0,3,1 (1ct 0st),0.076,1978,1981,JD Higgs ,AUS
1622,4,7,3,3,0,3,0,1 (1ct 0st),0.428,1936,1946,DD Hindlekar ,INDIA
1623,7,13,3,3,0,0,3,1 (1ct 0st),0.23,1989,1989,TV Hohns ,AUS
1624,7,14,3,3,0,0,3,2 (2ct 0st),0.214,1921,1932,P Holmes ,ENG
1625,5,9,3,3,0,0,3,1 (1ct 0st),0.3329999999999999,2017,2017,KA Hope ,WI
1626,4,7,3,3,0,0,3,1 (1ct 0st),0.428,1987,1990,PA Horne ,NZ
1627,8,14,3,3,0,0,3,1 (1ct 0st),0.214,1997,1998,AG Huckle ,ZIM
1628,12,22,3,3,0,0,3,1 (1ct 0st),0.136,1974,1979,AG Hurst ,AUS
1629,2,3,3,3,0,0,3,2 (2ct 0st),1.0,1889,1889,P Hutchinson ,SA
1630,2,4,3,3,0,0,3,2 (2ct 0st),0.75,1995,1995,Ijaz Ahmed jnr ,PAK
1631,2,2,3,2,1,2,0,2 (1ct 1st),1.5,1947,1947,JK Irani ,INDIA
1632,14,28,3,3,0,0,3,2 (2ct 0st),0.107,1928,1933,H Ironmonger ,AUS
1633,12,21,3,3,0,0,3,1 (1ct 0st),0.142,2011,2018,KM Jarvis ,ZIM
1634,13,24,3,3,0,0,3,2 (2ct 0st),0.125,1965,1973,TW Jarvis ,NZ
1635,4,8,3,3,0,0,3,2 (2ct 0st),0.375,1930,1935,CEL Jones ,WI
1636,5,9,3,3,0,0,3,1 (1ct 0st),0.3329999999999999,2004,2007,SC Joseph ,WI
1637,7,14,3,3,0,0,3,2 (2ct 0st),0.214,2014,2015,PHT Kaushal ,SL
1638,4,8,3,3,0,0,3,1 (1ct 0st),0.375,2001,2005,JM Kemp ,SA
1639,4,8,3,3,0,0,3,2 (2ct 0st),0.375,1964,1967,Khalid Ibadulla ,PAK
1640,4,7,3,3,0,0,3,1 (1ct 0st),0.428,2003,2003,RJ Kirtley ,ENG
1641,3,5,3,3,0,0,3,1 (1ct 0st),0.6,1902,1907,JJ Kotze ,SA
1642,6,11,3,3,0,0,3,1 (1ct 0st),0.272,2017,2019,Kuldeep Yadav ,INDIA
1643,9,15,3,3,0,0,3,1 (1ct 0st),0.2,1986,1991,GF Labrooy ,SL
1644,3,6,3,3,0,0,3,2 (2ct 0st),0.5,1978,1978,TJ Laughlin ,AUS
1645,13,26,3,3,0,0,3,1 (1ct 0st),0.115,2002,2005,JJC Lawson ,WI
1646,2,4,3,3,0,0,3,2 (2ct 0st),0.75,1951,1952,E Leadbeater ,ENG
1647,1,2,3,3,0,3,0,3 (3ct 0st),1.5,1934,1934,WHV Levett ,ENG
1648,1,2,3,3,0,3,0,3 (3ct 0st),1.5,1933,1933,HSB Love ,AUS
1649,14,25,3,3,0,0,3,1 (1ct 0st),0.12,1887,1897,JJ Lyons ,AUS
1650,11,22,3,3,0,0,3,1 (1ct 0st),0.136,1921,1921,EA McDonald ,AUS
1651,4,7,3,3,0,0,3,1 (1ct 0st),0.428,2003,2003,A McGrath ,ENG
1652,6,10,3,3,0,0,3,1 (1ct 0st),0.3,1892,1893,RW McLeod ,AUS
1653,2,3,3,2,1,2,0,3 (2ct 1st),1.0,1952,1953,ES Maka ,INDIA
1654,7,13,3,3,0,0,3,2 (2ct 0st),0.23,1948,1949,FG Mann ,ENG
1655,19,34,3,3,0,0,3,1 (1ct 0st),0.088,1947,1951,NBF Mann ,SA
1656,1,1,3,3,0,3,0,3 (3ct 0st),3.0,2009,2009,GA Manou ,AUS
1657,6,7,3,3,0,0,3,2 (2ct 0st),0.428,2004,2004,Manjural Islam Rana ,BDESH
1658,5,8,3,3,0,0,3,1 (1ct 0st),0.375,1897,1898,JR Mason ,ENG
1659,4,8,3,3,0,0,3,2 (2ct 0st),0.375,1981,1981,EH Mattis ,WI
1660,2,4,3,3,0,0,3,2 (2ct 0st),0.75,2018,2018,B Mavuta ,ZIM
1661,4,8,3,3,0,0,3,1 (1ct 0st),0.375,1988,1994,MP Maynard ,ENG
1662,6,12,3,3,0,0,3,1 (1ct 0st),0.25,1965,1970,LC Mayne ,AUS
1663,2,4,3,3,0,0,3,2 (2ct 0st),0.75,1923,1923,DJ Meintjes ,SA
1664,10,16,3,3,0,0,3,1 (1ct 0st),0.187,1946,1952,RS Modi ,INDIA
1665,23,45,3,3,0,0,3,1 (1ct 0st),0.066,2005,2010,Mohammad Asif ,PAK
1666,2,4,3,2,1,2,0,1 (1ct 0st),0.75,2011,2011,Mohammad Salman ,PAK
1667,3,6,3,3,0,0,3,2 (2ct 0st),0.5,1937,1937,DAR Moloney ,NZ
1668,3,6,3,3,0,0,3,1 (1ct 0st),0.5,1991,1991,H Morris ,ENG
1669,3,5,3,3,0,0,3,2 (2ct 0st),0.6,1990,1990,JE Morris ,ENG
1670,9,17,3,3,0,0,3,1 (1ct 0st),0.176,1959,1964,JB Mortimore ,ENG
1671,10,18,3,3,0,0,3,1 (1ct 0st),0.166,1952,1954,ARA Murray ,SA
1672,9,17,3,3,0,0,3,2 (2ct 0st),0.176,2004,2007,Naved-ul-Hasan ,PAK
1673,11,17,3,3,0,0,3,1 (1ct 0st),0.176,1934,1952,CS Nayudu ,INDIA
1674,4,7,3,3,0,0,3,3 (3ct 0st),0.428,1913,1914,C Newberry ,SA
1675,3,6,3,3,0,0,3,2 (2ct 0st),0.5,1930,1939,ES Newson ,SA
1676,5,9,3,3,0,0,3,1 (1ct 0st),0.3329999999999999,2018,2019,L Ngidi ,SA
1677,4,6,3,3,0,3,0,2 (2ct 0st),0.5,1935,1936,F Nicholson ,SA
1678,2,4,3,3,0,0,3,1 (1ct 0st),0.75,1931,1931,HC Nitschke ,AUS
1679,5,9,3,3,0,0,3,2 (2ct 0st),0.3329999999999999,1932,1936,LPJ O'Brien ,AUS
1680,4,8,3,3,0,0,3,1 (1ct 0st),0.375,1908,1909,JDA O'Connor ,AUS
1681,8,12,3,3,0,0,3,2 (2ct 0st),0.25,1992,1994,MB Owens ,NZ
1682,9,16,3,3,0,0,3,2 (2ct 0st),0.187,2004,2014,T Panyangara ,ZIM
1683,7,13,3,3,0,0,3,1 (1ct 0st),0.23,1950,1959,WGA Parkhouse ,ENG
1684,10,17,3,3,0,0,3,2 (2ct 0st),0.176,1920,1924,CH Parkin ,ENG
1685,6,11,3,3,0,0,3,1 (1ct 0st),0.272,2010,2017,WD Parnell ,SA
1686,1,2,3,3,0,0,3,2 (2ct 0st),1.5,1930,1930,CC Passailaigue ,WI
1687,6,12,3,3,0,0,3,1 (1ct 0st),0.25,2012,2015,SR Patel ,ENG
1688,17,32,3,3,0,0,3,1 (1ct 0st),0.093,1957,1965,AJ Pithey ,SA
1689,13,25,3,3,0,0,3,1 (1ct 0st),0.12,2005,2014,LE Plunkett ,ENG
1690,4,7,3,3,0,0,3,1 (1ct 0st),0.428,1946,1948,R Pollard ,ENG
1691,3,4,3,3,0,0,3,2 (2ct 0st),0.75,1896,1896,RM Poore ,SA
1692,1,2,3,2,1,2,0,2 (1ct 1st),1.5,2019,2019,SW Poynter ,IRE
1693,14,24,3,3,0,0,3,1 (1ct 0st),0.125,1990,1995,C Pringle ,NZ
1694,18,34,3,3,0,0,3,1 (1ct 0st),0.088,2009,2012,R Rampaul ,WI
1695,4,8,3,3,0,0,3,1 (1ct 0st),0.375,1970,1970,BA Richards ,SA
1696,5,8,3,3,0,0,3,2 (2ct 0st),0.375,1951,1952,F Ridgway ,ENG
1697,5,10,3,3,0,0,3,2 (2ct 0st),0.3,1962,1968,WV Rodriguez ,WI
1698,11,21,3,3,0,0,3,2 (2ct 0st),0.142,2016,2018,Sabbir Rahman ,BDESH
1699,5,9,3,3,0,0,3,1 (1ct 0st),0.3329999999999999,1965,1969,Salahuddin ,PAK
1700,21,41,3,3,0,0,3,1 (1ct 0st),0.073,1967,1978,Saleem Altaf ,PAK
1701,4,6,3,3,0,0,3,2 (2ct 0st),0.5,1988,1991,MAR Samarasekera ,SL
1702,10,19,3,3,0,0,3,1 (1ct 0st),0.157,2003,2005,Shabbir Ahmed ,PAK
1703,6,8,3,3,0,0,3,2 (2ct 0st),0.375,2018,2019,Shadman Islam ,BDESH
1704,12,23,3,3,0,0,3,1 (1ct 0st),0.13,1899,1907,WA Shalders ,SA
1705,3,5,3,3,0,0,3,1 (1ct 0st),0.6,2019,2019,DP Sibley ,ENG
1706,5,10,3,3,0,0,3,1 (1ct 0st),0.3,2015,2016,TAM Siriwardana ,SL
1707,3,6,3,3,0,0,3,1 (1ct 0st),0.5,1986,1986,WN Slack ,ENG
1708,3,4,3,3,0,0,3,2 (2ct 0st),0.75,1928,1930,JA Small ,WI
1709,9,16,3,3,0,0,3,1 (1ct 0st),0.187,1947,1957,VI Smith ,SA
1710,11,16,3,3,0,0,3,1 (1ct 0st),0.187,1958,1964,JT Sparling ,NZ
1711,13,24,3,3,0,0,3,1 (1ct 0st),0.125,1910,1912,LA Stricker ,SA
1712,15,27,3,3,0,0,3,1 (1ct 0st),0.111,1982,1985,Tahir Naqqash ,PAK
1713,14,26,3,3,0,0,3,1 (1ct 0st),0.115,1902,1913,LJ Tancred ,SA
1714,8,15,3,3,0,0,3,1 (1ct 0st),0.2,1965,1966,G Thomas ,AUS
1715,2,4,3,3,0,0,3,2 (2ct 0st),0.75,1877,1877,NFD Thomson ,AUS
1716,5,10,3,3,0,0,3,1 (1ct 0st),0.3,1964,1965,NI Thomson ,ENG
1717,10,18,3,3,0,0,3,2 (2ct 0st),0.166,2003,2010,T Thushara ,SL
1718,7,11,3,3,0,0,3,2 (2ct 0st),0.272,1885,1886,JW Trumble ,AUS
1719,10,17,3,3,0,0,3,2 (2ct 0st),0.176,1998,2002,AJ Tudor ,ENG
1720,2,3,3,3,0,3,0,2 (2ct 0st),1.0,1929,1936,EA van der Merwe ,SA
1721,3,5,3,3,0,0,3,2 (2ct 0st),0.6,1999,2000,R Vijay Bharadwaj ,INDIA
1722,5,10,3,3,0,0,3,1 (1ct 0st),0.3,1965,1972,GE Vivian ,NZ
1723,2,4,3,3,0,0,3,1 (1ct 0st),0.75,1961,1961,KA Walter ,SA
1724,5,9,3,3,0,0,3,2 (2ct 0st),0.3329999999999999,1969,1976,A Ward ,ENG
1725,15,28,3,3,0,0,3,2 (2ct 0st),0.107,1899,1912,PF Warner ,ENG
1726,8,13,3,3,0,0,3,1 (1ct 0st),0.23,2015,2019,JA Warrican ,WI
1727,1,2,3,3,0,0,3,2 (2ct 0st),1.5,2005,2005,DM Washington ,WI
1728,11,16,3,3,0,0,3,1 (1ct 0st),0.187,1930,1937,GL Weir ,NZ
1729,26,44,3,3,0,0,3,1 (1ct 0st),0.068,1976,1986,P Willey ,ENG
1730,4,8,3,2,1,2,0,2 (1ct 1st),0.375,1888,1892,H Wood ,ENG
1731,6,10,3,3,0,0,3,2 (2ct 0st),0.3,1948,1950,OE Wynne ,SA
1732,1,2,3,1,2,1,0,2 (0ct 2st),1.5,1993,1993,V Yadav ,INDIA
1733,6,12,2,2,0,0,2,2 (2ct 0st),0.166,1993,1995,Aamer Nazir ,PAK
1734,22,38,2,2,0,0,2,1 (1ct 0st),0.052,1989,1998,Aaqib Javed ,PAK
1735,2,4,2,2,0,0,2,1 (1ct 0st),0.5,1961,1964,Afaq Hussain ,PAK
1736,2,4,2,2,0,0,2,1 (1ct 0st),0.5,1880,1884,G Alexander ,AUS
1737,1,2,2,2,0,0,2,2 (2ct 0st),1.0,1887,1887,RC Allen ,AUS
1738,10,16,2,2,0,0,2,1 (1ct 0st),0.125,1996,1999,GI Allott ,NZ
1739,6,9,2,2,0,0,2,1 (1ct 0st),0.222,2017,2018,SW Ambris ,WI
1740,4,7,2,2,0,0,2,1 (1ct 0st),0.285,2013,2014,Anamul Haque ,BDESH
1741,7,12,2,2,0,0,2,1 (1ct 0st),0.166,1952,1953,ML Apte ,INDIA
1742,2,4,2,2,0,0,2,1 (1ct 0st),0.5,2018,2018,Ariful Haque ,BDESH
1743,13,24,2,2,0,0,2,1 (1ct 0st),0.083,1987,1989,Arshad Ayub ,INDIA
1744,2,3,2,2,0,0,2,1 (1ct 0st),0.6659999999999999,1986,1987,B Arun ,INDIA
1745,4,7,2,2,0,0,2,1 (1ct 0st),0.285,2018,2019,Asghar Afghan ,AFG
1746,4,8,2,2,0,0,2,1 (1ct 0st),0.25,2012,2019,TD Astle ,NZ
1747,13,23,2,2,0,0,2,1 (1ct 0st),0.086,1992,1996,Ata-ur-Rehman ,PAK
1748,8,15,2,2,0,0,2,1 (1ct 0st),0.133,1958,1959,ES Atkinson ,WI
1749,2,4,2,2,0,0,2,1 (1ct 0st),0.5,1978,1978,RA Austin ,WI
1750,2,3,2,2,0,0,2,1 (1ct 0st),0.6659999999999999,2010,2010,S Badrinath ,INDIA
1751,3,6,2,2,0,0,2,2 (2ct 0st),0.3329999999999999,1975,1976,L Baichan ,WI
1752,10,20,2,2,0,0,2,1 (1ct 0st),0.1,1983,1990,EAE Baptiste ,WI
1753,5,8,2,2,0,0,2,1 (1ct 0st),0.25,1929,1930,F Barratt ,ENG
1754,5,7,2,2,0,0,2,1 (1ct 0st),0.285,1928,1931,EL Bartlett ,WI
1755,1,2,2,2,0,0,2,2 (2ct 0st),1.0,2005,2005,Bazid Khan ,PAK
1756,4,7,2,2,0,0,2,2 (2ct 0st),0.285,1952,1956,DD Beard ,NZ
1757,5,7,2,2,0,0,2,1 (1ct 0st),0.285,1912,1914,R Beaumont ,SA
1758,5,8,2,2,0,0,2,1 (1ct 0st),0.25,1948,1950,DW Begbie ,SA
1759,26,50,2,2,0,0,2,1 (1ct 0st),0.04,1992,1998,KCG Benjamin ,WI
1760,2,4,2,2,0,0,2,2 (2ct 0st),0.5,1950,1950,R Berry ,ENG
1761,4,7,2,2,0,0,2,1 (1ct 0st),0.285,1993,2003,MP Bicknell ,ENG
1762,5,10,2,2,0,0,2,2 (2ct 0st),0.2,2018,2018,Bilal Asif ,PAK
1763,9,17,2,2,0,0,2,1 (1ct 0st),0.1169999999999999,2012,2017,JM Bird ,AUS
1764,3,6,2,2,0,0,2,2 (2ct 0st),0.3329999999999999,1928,1929,DD Blackie ,AUS
1765,2,2,2,2,0,2,0,1 (1ct 0st),1.0,1993,1993,RJ Blakey ,ENG
1766,12,23,2,2,0,0,2,1 (1ct 0st),0.086,2009,2010,DE Bollinger ,AUS
1767,7,14,2,2,0,0,2,1 (1ct 0st),0.142,1963,1964,JB Bolus ,ENG
1768,1,2,2,2,0,0,2,2 (2ct 0st),1.0,2014,2014,SG Borthwick ,ENG
1769,15,29,2,2,0,0,2,1 (1ct 0st),0.068,1932,1946,WE Bowes ,ENG
1770,5,8,2,2,0,0,2,1 (1ct 0st),0.25,1929,1930,EH Bowley ,ENG
1771,5,10,2,2,0,0,2,1 (1ct 0st),0.2,2003,2005,NW Bracken ,AUS
1772,2,4,2,2,0,0,2,1 (1ct 0st),0.5,1964,1964,WP Bradburn ,NZ
1773,3,6,2,2,0,0,2,1 (1ct 0st),0.3329999999999999,1922,1923,WH Brann ,SA
1774,2,3,2,2,0,0,2,1 (1ct 0st),0.6659999999999999,1933,1934,EH Bromley ,AUS
1775,4,8,2,2,0,0,2,1 (1ct 0st),0.25,1910,1910,CP Buckenham ,ENG
1776,2,4,2,1,1,0,1,1 (1ct 0st),0.5,1887,1888,FJ Burton ,AUS
1777,10,14,2,2,0,0,2,1 (1ct 0st),0.142,1947,1953,TB Burtt ,NZ
1778,3,6,2,1,1,1,0,1 (1ct 0st),0.3329999999999999,1896,1896,HR Butt ,ENG
1779,7,12,2,2,0,0,2,1 (1ct 0st),0.166,1985,1988,CG Butts ,WI
1780,19,35,2,2,0,0,2,1 (1ct 0st),0.057,1961,1965,FJ Cameron ,NZ
1781,1,2,2,2,0,0,2,2 (2ct 0st),1.0,2019,2019,J Cameron-Dow ,IRE
1782,2,4,2,2,0,0,2,1 (1ct 0st),0.5,1979,1979,PH Carlson ,AUS
1783,10,16,2,2,0,0,2,1 (1ct 0st),0.125,1912,1924,CP Carter ,SA
1784,5,9,2,2,0,0,2,2 (2ct 0st),0.222,1964,1965,TW Cartwright ,ENG
1785,1,2,2,2,0,0,2,2 (2ct 0st),1.0,2008,2008,B Casson ,AUS
1786,5,7,2,2,0,0,2,2 (2ct 0st),0.285,2015,2016,R Chandrika ,WI
1787,3,6,2,2,0,0,2,1 (1ct 0st),0.3329999999999999,1981,1981,TM Chappell ,AUS
1788,11,19,2,2,0,0,2,1 (1ct 0st),0.105,1978,1982,ST Clarke ,WI
1789,2,4,2,2,0,0,2,2 (2ct 0st),0.5,1932,1933,SHM Colah ,INDIA
1790,3,6,2,2,0,0,2,1 (1ct 0st),0.3329999999999999,1994,1995,JB Commins ,SA
1791,1,2,2,2,0,0,2,2 (2ct 0st),1.0,1877,1877,BB Cooper ,AUS
1792,3,6,2,2,0,0,2,1 (1ct 0st),0.3329999999999999,2011,2011,TA Copeland ,AUS
1793,4,8,2,2,0,0,2,1 (1ct 0st),0.25,1969,1973,RMH Cottam ,ENG
1794,11,20,2,2,0,0,2,1 (1ct 0st),0.1,1953,1958,ID Craig ,AUS
1795,14,23,2,2,0,0,2,1 (1ct 0st),0.086,2016,2019,ML Cummins ,WI
1796,14,27,2,2,0,0,2,2 (2ct 0st),0.074,2018,2019,SM Curran ,ENG
1797,2,4,2,2,0,0,2,2 (2ct 0st),0.5,1899,1899,WR Cuttell ,ENG
1798,3,5,2,2,0,0,2,2 (2ct 0st),0.4,2016,2017,LA Dawson ,ENG
1799,3,5,2,2,0,0,2,1 (1ct 0st),0.4,1912,1912,H Dean ,ENG
1800,10,15,2,2,0,0,2,1 (1ct 0st),0.133,1930,1933,CS Dempster ,NZ
1801,4,6,2,2,0,0,2,2 (2ct 0st),0.3329999999999999,2010,2013,XJ Doherty ,AUS
1802,5,9,2,2,0,0,2,1 (1ct 0st),0.222,1892,1896,H Donnan ,AUS
1803,1,2,2,2,0,0,2,1 (1ct 0st),1.0,1899,1899,RR Dower ,SA
1804,12,23,2,2,0,0,2,1 (1ct 0st),0.086,2002,2004,VC Drakes ,WI
1805,3,6,2,2,0,0,2,1 (1ct 0st),0.3329999999999999,1927,1929,JP Duminy ,SA
1806,4,7,2,2,0,0,2,1 (1ct 0st),0.285,1933,1937,JA Dunning ,NZ
1807,2,4,2,2,0,0,2,1 (1ct 0st),0.5,1967,1967,JH du Preez ,SA
1808,2,4,2,2,0,0,2,1 (1ct 0st),0.5,1896,1902,CJ Eady ,AUS
1809,5,8,2,2,0,0,2,1 (1ct 0st),0.25,1979,1982,Ehteshamuddin ,PAK
1810,5,9,2,2,0,0,2,2 (2ct 0st),0.222,2008,2009,GD Elliott ,NZ
1811,11,22,2,2,0,0,2,1 (1ct 0st),0.09,1984,1986,RM Ellison ,ENG
1812,4,5,2,2,0,0,2,1 (1ct 0st),0.4,1912,1912,SH Emery ,AUS
1813,6,12,2,2,0,0,2,1 (1ct 0st),0.166,1962,1964,WS Farrer ,SA
1814,5,8,2,2,0,0,2,1 (1ct 0st),0.25,1998,2004,Fazl-e-Akbar ,PAK
1815,4,7,2,2,0,0,2,1 (1ct 0st),0.285,1960,1960,JP Fellows-Smith ,SA
1816,7,12,2,2,0,0,2,1 (1ct 0st),0.166,2016,2019,MVT Fernando ,SL
1817,2,3,2,2,0,0,2,1 (1ct 0st),0.6659999999999999,1892,1896,CG Fichardt ,SA
1818,8,15,2,2,0,0,2,1 (1ct 0st),0.133,1884,1893,W Flowers ,ENG
1819,13,19,2,2,0,0,2,1 (1ct 0st),0.105,2001,2004,TJ Friend ,ZIM
1820,1,2,2,2,0,0,2,1 (1ct 0st),1.0,2001,2001,LV Garrick ,WI
1821,8,15,2,2,0,0,2,1 (1ct 0st),0.133,1947,1949,C Gladwin ,ENG
1822,1,2,2,2,0,0,2,1 (1ct 0st),1.0,1896,1896,RA Gleeson ,SA
1823,8,14,2,2,0,0,2,1 (1ct 0st),0.142,1951,1960,CD Gopinath ,INDIA
1824,1,2,2,2,0,0,2,2 (2ct 0st),1.0,1880,1880,GF Grace ,ENG
1825,2,4,2,2,0,0,2,2 (2ct 0st),0.5,1899,1899,R Graham ,SA
1826,2,4,2,2,0,0,2,1 (1ct 0st),0.5,1877,1877,A Greenwood ,ENG
1827,2,4,2,2,0,0,2,2 (2ct 0st),0.5,1958,1960,GM Guard ,INDIA
1828,4,8,2,2,0,0,2,1 (1ct 0st),0.25,1967,1969,S Guha ,INDIA
1829,6,9,2,2,0,0,2,1 (1ct 0st),0.222,1999,2005,DA Gunawardene ,SL
1830,1,2,2,2,0,0,2,1 (1ct 0st),1.0,1990,1990,Gursharan Singh ,INDIA
1831,12,15,2,2,0,0,2,1 (1ct 0st),0.133,1955,1961,JW Guy ,NZ
1832,5,10,2,2,0,0,2,2 (2ct 0st),0.2,1973,1973,JR Hammond ,AUS
1833,4,7,2,2,0,0,2,1 (1ct 0st),0.285,1879,1884,Lord Harris ,ENG
1834,2,3,2,2,0,0,2,1 (1ct 0st),0.6659999999999999,1906,1906,JC Hartley ,ENG
1835,4,6,2,2,0,0,2,2 (2ct 0st),0.3329999999999999,1992,1995,MJ Haslam ,NZ
1836,5,10,2,2,0,0,2,1 (1ct 0st),0.2,1906,1912,EG Hayes ,ENG
1837,2,4,2,2,0,0,2,1 (1ct 0st),0.5,1973,1973,RGA Headley ,WI
1838,7,14,2,2,0,0,2,1 (1ct 0st),0.142,2001,2002,CW Henderson ,SA
1839,3,5,2,2,0,0,2,2 (2ct 0st),0.4,1992,1993,O Henry ,SA
1840,3,5,2,2,0,0,2,1 (1ct 0st),0.4,1953,1955,JC Hill ,AUS
1841,1,2,2,2,0,0,2,1 (1ct 0st),1.0,1961,1961,DE Hoare ,AUS
1842,7,11,2,2,0,0,2,1 (1ct 0st),0.181,1983,1984,TG Hogan ,AUS
1843,13,23,2,2,0,0,2,1 (1ct 0st),0.086,1935,1950,WE Hollies ,ENG
1844,2,4,2,2,0,0,2,1 (1ct 0st),0.5,1997,1998,BC Hollioake ,ENG
1845,1,2,2,2,0,2,0,2 (2ct 0st),1.0,1879,1879,L Hone ,ENG
1846,2,4,2,2,0,0,2,1 (1ct 0st),0.5,1959,1959,MJ Horton ,ENG
1847,5,10,2,2,0,0,2,1 (1ct 0st),0.2,1947,1948,R Howorth ,ENG
1848,2,4,2,2,0,0,2,2 (2ct 0st),0.5,1930,1931,A Hurwood ,AUS
1849,3,5,2,2,0,0,2,2 (2ct 0st),0.4,1996,1999,RC Irani ,ENG
1850,1,2,2,2,0,0,2,1 (1ct 0st),1.0,2000,2000,Irfan Fazil ,PAK
1851,4,8,2,2,0,0,2,1 (1ct 0st),0.25,1970,1970,BL Irvine ,SA
1852,5,10,2,2,0,0,2,1 (1ct 0st),0.2,1950,1951,JB Iverson ,AUS
1853,1,2,2,2,0,0,2,2 (2ct 0st),1.0,1933,1933,RJD Jamshedji ,INDIA
1854,5,8,2,2,0,0,2,1 (1ct 0st),0.25,1992,1994,MP Jarvis ,ZIM
1855,9,16,2,2,0,0,2,1 (1ct 0st),0.125,1988,1993,PW Jarvis ,ENG
1856,2,4,2,2,0,0,2,1 (1ct 0st),0.5,2015,2015,MDUS Jayasundera ,SL
1857,6,9,2,2,0,0,2,1 (1ct 0st),0.222,1983,1984,VB John ,SL
1858,1,2,2,2,0,0,2,2 (2ct 0st),1.0,1948,1948,LJ Johnson ,AUS
1859,6,9,2,2,0,0,2,1 (1ct 0st),0.222,2014,2015,Jubair Hossain ,BDESH
1860,2,4,2,2,0,0,2,2 (2ct 0st),0.5,1877,1877,H Jupp ,ENG
1861,2,3,2,2,0,0,2,2 (2ct 0st),0.6659999999999999,1985,1986,BR Jurangpathy ,SL
1862,1,1,2,2,0,0,2,2 (2ct 0st),2.0,2005,2005,S Kalavitigoda ,SL
1863,2,4,2,2,0,0,2,2 (2ct 0st),0.5,1982,1982,LWS Kaluperuma ,SL
1864,8,15,2,2,0,0,2,1 (1ct 0st),0.133,2000,2004,M Kartik ,INDIA
1865,2,4,2,2,0,0,2,1 (1ct 0st),0.5,1877,1877,TK Kendall ,AUS
1866,4,8,2,2,0,0,2,1 (1ct 0st),0.25,1996,1996,RJ Kennedy ,NZ
1867,12,17,2,2,0,0,2,1 (1ct 0st),0.1169999999999999,2001,2003,Khaled Mahmud ,BDESH
1868,2,4,2,2,0,0,2,1 (1ct 0st),0.5,1929,1929,ET Killick ,ENG
1869,2,4,2,2,0,0,2,1 (1ct 0st),0.5,1962,1968,LA King ,WI
1870,19,34,2,2,0,0,2,1 (1ct 0st),0.0579999999999999,1999,2005,RD King ,WI
1871,4,7,2,2,0,0,2,1 (1ct 0st),0.285,2012,2013,RK Kleinveldt ,SA
1872,6,11,2,2,0,0,2,2 (2ct 0st),0.181,2011,2011,P Kumar ,INDIA
1873,2,4,2,2,0,0,2,1 (1ct 0st),0.5,1961,1961,VV Kumar ,INDIA
1874,1,2,2,2,0,0,2,1 (1ct 0st),1.0,2011,2011,GA Lamb ,ZIM
1875,6,11,2,2,0,0,2,1 (1ct 0st),0.181,2005,2006,CK Langeveldt ,SA
1876,5,10,2,2,0,0,2,2 (2ct 0st),0.2,1961,1962,GB Lawrence ,SA
1877,5,9,2,2,0,0,2,1 (1ct 0st),0.222,1906,1906,WS Lees ,ENG
1878,1,2,2,2,0,0,2,2 (2ct 0st),1.0,1954,1954,IB Leggat ,NZ
1879,13,26,2,2,0,0,2,1 (1ct 0st),0.076,1954,1959,PJ Loader ,ENG
1880,4,7,2,2,0,2,0,1 (1ct 0st),0.285,1880,1884,Hon.A Lyttelton ,ENG
1881,4,7,2,2,0,0,2,1 (1ct 0st),0.285,2009,2009,AB McDonald ,AUS
1882,4,8,2,2,0,0,2,1 (1ct 0st),0.25,2001,2001,NC McGarrell ,WI
1883,3,5,2,2,0,0,2,1 (1ct 0st),0.4,1885,1888,PG McShane ,AUS
1884,3,6,2,2,0,0,2,1 (1ct 0st),0.3329999999999999,2016,2016,NJ Maddinson ,AUS
1885,2,4,2,2,0,0,2,1 (1ct 0st),0.5,1958,1958,IS Madray ,WI
1886,3,5,2,2,0,0,2,2 (2ct 0st),0.4,1983,1984,JN Maguire ,AUS
1887,7,11,2,2,0,0,2,1 (1ct 0st),0.181,1982,1985,AO Malhotra ,INDIA
1888,4,7,2,2,0,0,2,1 (1ct 0st),0.285,1977,1978,AL Mann ,AUS
1889,5,9,2,2,0,0,2,1 (1ct 0st),0.222,2000,2002,DA Marillier ,ZIM
1890,3,4,2,2,0,0,2,1 (1ct 0st),0.5,2013,2014,Marshall Ayub ,BDESH
1891,2,4,2,2,0,0,2,1 (1ct 0st),0.5,1890,1892,F Martin ,ENG
1892,9,12,2,2,0,0,2,1 (1ct 0st),0.166,1928,1931,FR Martin ,WI
1893,5,9,2,2,0,0,2,1 (1ct 0st),0.222,2012,2014,SW Masakadza ,ZIM
1894,2,3,2,2,0,0,2,2 (2ct 0st),0.6659999999999999,1930,1931,AM Matheson ,NZ
1895,4,7,2,2,0,0,2,2 (2ct 0st),0.285,1912,1921,ER Mayne ,AUS
1896,15,25,2,2,0,0,2,1 (1ct 0st),0.08,1996,2000,M Mbangwa ,ZIM
1897,2,4,2,2,0,0,2,1 (1ct 0st),0.5,2019,2019,JA McCollum ,IRE
1898,7,11,2,2,0,0,2,1 (1ct 0st),0.181,2007,2009,Mehrab Hossain jnr ,BDESH
1899,19,31,2,2,0,0,2,1 (1ct 0st),0.064,2008,2014,BAW Mendis ,SL
1900,6,10,2,2,0,0,2,2 (2ct 0st),0.2,1930,1931,WE Merritt ,NZ
1901,4,7,2,2,0,0,2,1 (1ct 0st),0.285,1960,1961,AG Milkha Singh ,INDIA
1902,3,4,2,2,0,0,2,1 (1ct 0st),0.5,1889,1892,WH Milton ,SA
1903,5,8,2,2,0,0,2,1 (1ct 0st),0.25,1899,1912,F Mitchell ,ENG
1904,7,10,2,2,0,0,2,1 (1ct 0st),0.2,2018,2019,Mohammad Mithun ,BDESH
1905,3,5,2,2,0,0,2,2 (2ct 0st),0.4,2018,2019,Mohammad Nabi ,AFG
1906,3,6,2,2,0,0,2,1 (1ct 0st),0.3329999999999999,2016,2016,Mohammad Nawaz ,PAK
1907,17,21,2,2,0,0,2,1 (1ct 0st),0.095,1951,1959,AM Moir ,NZ
1908,3,5,2,2,0,0,2,1 (1ct 0st),0.4,2017,2019,Mosaddek Hossain ,BDESH
1909,2,4,2,2,0,0,2,1 (1ct 0st),0.5,1999,1999,SA Muller ,AUS
1910,2,4,2,2,0,0,2,1 (1ct 0st),0.5,2014,2014,N M'shangwe ,ZIM
1911,2,3,2,2,0,0,2,2 (2ct 0st),0.6659999999999999,2019,2019,S Muthusamy ,SA
1912,8,15,2,2,0,0,2,1 (1ct 0st),0.133,2008,2012,Naeem Islam ,BDESH
1913,11,15,2,2,0,0,2,1 (1ct 0st),0.133,2004,2006,Nafees Iqbal ,BDESH
1914,5,8,2,2,0,0,2,2 (2ct 0st),0.25,2000,2002,MV Nagamootoo ,WI
1915,1,2,2,2,0,0,2,2 (2ct 0st),1.0,1980,1980,R Nanan ,WI
1916,6,11,2,2,0,0,2,1 (1ct 0st),0.181,2012,2013,SP Narine ,WI
1917,2,4,2,2,0,0,2,2 (2ct 0st),0.5,2017,2018,Najmul Hossain Shanto ,BDESH
1918,2,4,2,2,0,0,2,1 (1ct 0st),0.5,2012,2012,RJ Nicol ,NZ
1919,6,11,2,2,0,0,2,1 (1ct 0st),0.181,1932,1936,M Nissar ,INDIA
1920,4,7,2,2,0,0,2,2 (2ct 0st),0.285,1971,1971,JM Noreiga ,WI
1921,4,5,2,2,0,1,1,1 (1ct 0st),0.4,1928,1930,RK Nunes ,WI
1922,3,6,2,2,0,0,2,1 (1ct 0st),0.3329999999999999,2014,2016,J Nyumbu ,ZIM
1923,1,2,2,2,0,2,0,2 (2ct 0st),1.0,2018,2018,NJ O'Brien ,IRE
1924,4,8,2,2,0,0,2,2 (2ct 0st),0.25,1929,1930,J O'Connor ,ENG
1925,10,20,2,2,0,0,2,1 (1ct 0st),0.1,2017,2019,D Olivier ,SA
1926,11,19,2,2,0,0,2,1 (1ct 0st),0.105,1973,1976,DR O'Sullivan ,NZ
1927,2,4,2,2,0,0,2,1 (1ct 0st),0.5,1902,1902,LCH Palairet ,ENG
1928,2,3,2,2,0,0,2,1 (1ct 0st),0.6659999999999999,2014,2014,Pankaj Singh ,INDIA
1929,3,6,2,2,0,0,2,1 (1ct 0st),0.3329999999999999,1976,1976,NM Parker ,NZ
1930,14,27,2,2,0,0,2,1 (1ct 0st),0.074,1977,1982,LS Pascoe ,AUS
1931,7,11,2,2,0,0,2,1 (1ct 0st),0.181,1955,1960,JM Patel ,INDIA
1932,2,4,2,2,0,0,2,2 (2ct 0st),0.5,1996,1996,MM Patel ,ENG
1933,1,2,2,2,0,0,2,1 (1ct 0st),1.0,1934,1934,Yuvraj of Patiala ,INDIA
1934,3,5,2,2,0,0,2,1 (1ct 0st),0.4,2018,2019,KMA Paul ,WI
1935,9,15,2,2,0,0,2,1 (1ct 0st),0.133,1881,1886,E Peate ,ENG
1936,8,14,2,2,0,0,2,1 (1ct 0st),0.142,1999,2002,PDRL Perera ,SL
1937,6,11,2,2,0,0,2,1 (1ct 0st),0.181,2012,2015,V Permaul ,WI
1938,4,8,2,2,0,0,2,1 (1ct 0st),0.25,2017,2018,AL Phehlukwayo ,SA
1939,3,6,2,2,0,0,2,2 (2ct 0st),0.3329999999999999,2018,2019,WTS Porterfield ,IRE
1940,3,6,2,2,0,0,2,1 (1ct 0st),0.3329999999999999,1960,1960,JE Pothecary ,SA
1941,1,2,2,2,0,0,2,1 (1ct 0st),1.0,1892,1892,AD Pougher ,ENG
1942,1,2,2,2,0,0,2,2 (2ct 0st),1.0,1899,1899,AW Powell ,SA
1943,1,2,2,2,0,2,0,2 (2ct 0st),1.0,1938,1938,WFF Price ,ENG
1944,2,4,2,2,0,0,2,1 (1ct 0st),0.5,1927,1928,HLE Promnitz ,SA
1945,28,50,2,2,0,0,2,1 (1ct 0st),0.04,1959,1963,G Pullar ,ENG
1946,4,6,2,2,0,0,2,2 (2ct 0st),0.3329999999999999,2017,2018,PM Pushpakumara ,SL
1947,3,5,2,2,0,0,2,1 (1ct 0st),0.4,1992,1992,AJ Pycroft ,ZIM
1948,12,20,2,2,0,0,2,1 (1ct 0st),0.1,1982,1991,CG Rackemann ,AUS
1949,4,7,2,2,0,0,2,1 (1ct 0st),0.285,2018,2019,Rahmat Shah ,AFG
1950,1,2,2,2,0,0,2,2 (2ct 0st),1.0,2005,2005,RR Ramdass ,WI
1951,9,13,2,2,0,0,2,1 (1ct 0st),0.153,1994,1997,S Ranatunga ,SL
1952,4,7,2,2,0,0,2,1 (1ct 0st),0.285,1982,1985,Rashid Khan ,PAK
1953,8,15,2,2,0,0,2,1 (1ct 0st),0.133,1966,1968,DA Renneberg ,AUS
1954,3,5,2,2,0,0,2,1 (1ct 0st),0.4,1935,1936,JB Robertson ,SA
1955,2,3,2,2,0,0,2,2 (2ct 0st),0.6659999999999999,1889,1889,A Rose-Innes ,SA
1956,4,5,2,2,0,0,2,1 (1ct 0st),0.4,1892,1896,TW Routledge ,SA
1957,1,2,2,2,0,0,2,2 (2ct 0st),1.0,1879,1879,VPFA Royle ,ENG
1958,14,26,2,2,0,0,2,1 (1ct 0st),0.076,1986,1992,Saleem Jaffar ,PAK
1959,3,6,2,2,0,0,2,1 (1ct 0st),0.3329999999999999,1960,1960,RO Scarlett ,WI
1960,9,15,2,2,0,0,2,1 (1ct 0st),0.133,1992,1997,BN Schultz ,SA
1961,3,6,2,2,0,0,2,1 (1ct 0st),0.3329999999999999,1991,1991,CP Senanayake ,SL
1962,7,12,2,2,0,0,2,1 (1ct 0st),0.166,1963,1970,MA Seymour ,SA
1963,11,21,2,2,0,0,2,1 (1ct 0st),0.095,2010,2017,Shafiul Islam ,BDESH
1964,6,9,2,2,0,0,2,1 (1ct 0st),0.222,2006,2009,OA Shah ,ENG
1965,1,2,2,2,0,2,0,2 (2ct 0st),1.0,1976,1976,Shahid Israr ,PAK
1966,1,2,2,2,0,0,2,1 (1ct 0st),1.0,2010,2010,A Shahzad ,ENG
1967,5,9,2,2,0,0,2,1 (1ct 0st),0.222,1985,1990,G Sharma ,INDIA
1968,3,6,2,2,0,0,2,2 (2ct 0st),0.3329999999999999,1959,1959,DA Sharpe ,PAK
1969,3,6,2,2,0,0,2,1 (1ct 0st),0.3329999999999999,1890,1892,JW Sharpe ,ENG
1970,2,4,2,2,0,0,2,2 (2ct 0st),0.5,2018,2018,PP Shaw ,INDIA
1971,9,18,2,2,0,0,2,1 (1ct 0st),0.111,1963,1965,BK Shepherd ,AUS
1972,2,3,2,2,0,0,2,2 (2ct 0st),0.6659999999999999,1896,1899,GH Shepstone ,SA
1973,7,12,2,2,0,0,2,2 (2ct 0st),0.166,1969,1972,GC Shillingford ,WI
1974,10,17,2,2,0,0,2,1 (1ct 0st),0.1169999999999999,1963,1974,MJF Shrimpton ,NZ
1975,12,21,2,2,0,0,2,1 (1ct 0st),0.095,2013,2018,Sikandar Raza ,ZIM
1976,12,23,2,2,0,0,2,1 (1ct 0st),0.086,2017,2019,ARS Silva ,SL
1977,6,9,2,2,0,0,2,1 (1ct 0st),0.222,1996,2002,CEW Silverwood ,ENG
1978,3,5,2,2,0,0,2,2 (2ct 0st),0.4,1964,1966,DJ Sincock ,AUS
1979,2,4,2,2,0,0,2,1 (1ct 0st),0.5,1960,1960,CK Singh ,WI
1980,3,6,2,2,0,0,2,1 (1ct 0st),0.3329999999999999,2017,2017,VA Singh ,WI
1981,3,6,2,2,0,0,2,2 (2ct 0st),0.3329999999999999,1902,1902,CJE Smith ,SA
1982,5,8,2,2,0,0,2,1 (1ct 0st),0.25,1961,1962,DR Smith ,ENG
1983,3,4,2,2,0,2,0,2 (2ct 0st),0.5,1889,1896,FW Smith ,SA
1984,1,2,2,2,0,0,2,2 (2ct 0st),1.0,1907,1907,SD Snooke ,SA
1985,9,17,2,2,0,0,2,1 (1ct 0st),0.1169999999999999,2009,2016,Sohail Khan ,PAK
1986,2,4,2,2,0,0,2,1 (1ct 0st),0.5,2007,2007,Sohail Tanvir ,PAK
1987,4,6,2,2,0,0,2,1 (1ct 0st),0.3329999999999999,1946,1951,SW Sohoni ,INDIA
1988,2,4,2,2,0,0,2,1 (1ct 0st),0.5,1877,1877,J Southerton ,ENG
1989,5,9,2,2,0,0,2,1 (1ct 0st),0.222,1999,1999,GR Stead ,NZ
1990,4,8,2,2,0,0,2,1 (1ct 0st),0.25,1959,1960,GB Stevens ,AUS
1991,1,2,2,2,0,0,2,2 (2ct 0st),1.0,1889,1889,RB Stewart ,SA
1992,6,12,2,2,0,0,2,1 (1ct 0st),0.166,2000,2001,CEL Stuart ,WI
1993,2,3,2,2,0,0,2,1 (1ct 0st),0.6659999999999999,2018,2019,Khaled Ahmed ,BDESH
1994,2,3,2,2,0,0,2,1 (1ct 0st),0.6659999999999999,1889,1889,AB Tancred ,SA
1995,1,2,2,2,0,0,2,1 (1ct 0st),1.0,1902,1902,FW Tate ,ENG
1996,3,5,2,2,0,0,2,1 (1ct 0st),0.4,1947,1956,DD Taylor ,NZ
1997,2,3,2,2,0,0,2,1 (1ct 0st),0.6659999999999999,1984,1984,VP Terry ,ENG
1998,7,13,2,2,0,0,2,1 (1ct 0st),0.153,2014,2018,DT Tiripano ,ZIM
1999,4,8,2,2,0,0,2,1 (1ct 0st),0.25,1930,1934,LF Townsend ,ENG
2000,2,4,2,2,0,0,2,1 (1ct 0st),0.5,2010,2015,JC Tredwell ,ENG
2001,4,8,2,2,0,0,2,1 (1ct 0st),0.25,1948,1952,J Trim ,WI
2002,15,28,2,2,0,0,2,1 (1ct 0st),0.071,1976,1986,GB Troup ,NZ
2003,1,2,2,2,0,0,2,2 (2ct 0st),1.0,1914,1914,LR Tuckett ,SA
2004,14,25,2,2,0,0,2,1 (1ct 0st),0.08,1921,1929,GE Tyldesley ,ENG
2005,2,4,2,2,0,0,2,1 (1ct 0st),0.5,2018,2018,ML Udawatte ,SL
2006,4,6,2,2,0,0,2,2 (2ct 0st),0.3329999999999999,2004,2013,P Utseya ,ZIM
2007,7,13,2,2,0,0,2,1 (1ct 0st),0.153,1933,1939,BH Valentine ,ENG
2008,4,7,2,2,0,0,2,1 (1ct 0st),0.285,2011,2013,BV Vitori ,ZIM
2009,5,8,2,2,0,0,2,1 (1ct 0st),0.25,1893,1898,E Wainwright ,ENG
2010,1,1,2,2,0,0,2,2 (2ct 0st),2.0,1885,1885,FH Walters ,AUS
2011,4,7,2,2,0,0,2,1 (1ct 0st),0.285,1982,1982,B Warnapura ,SL
2012,4,7,2,2,0,0,2,1 (1ct 0st),0.285,1955,1955,WJ Watson ,AUS
2013,2,4,2,2,0,0,2,1 (1ct 0st),0.5,1980,1980,PN Webb ,NZ
2014,1,2,2,2,0,0,2,2 (2ct 0st),1.0,1879,1879,AJ Webbe ,ENG
2015,2,4,2,2,0,0,2,2 (2ct 0st),0.5,1937,1938,AW Wellard ,ENG
2016,2,3,2,2,0,0,2,2 (2ct 0st),0.6659999999999999,1983,1983,MD Wettimuny ,SL
2017,12,24,2,2,0,0,2,1 (1ct 0st),0.083,1981,1992,MR Whitney ,AUS
2018,4,8,2,2,0,0,2,1 (1ct 0st),0.25,1939,1948,EAV Williams ,WI
2019,1,2,2,2,0,2,0,2 (2ct 0st),1.0,2010,2010,Zulqarnain Haider ,PAK
2020,9,15,1,1,0,0,1,1 (1ct 0st),0.066,2011,2015,VR Aaron ,INDIA
2021,4,8,1,0,1,0,0,1 (0ct 1st),0.125,1964,1965,Abdul Kadir ,PAK
2022,7,9,1,1,0,0,1,1 (1ct 0st),0.111,2018,2019,Abu Jayed ,BDESH
2023,4,8,1,1,0,0,1,1 (1ct 0st),0.125,1998,1998,HD Ackerman ,SA
2024,1,2,1,1,0,0,1,1 (1ct 0st),0.5,2019,2019,MR Adair ,IRE
2025,1,2,1,1,0,0,1,1 (1ct 0st),0.5,2002,2002,AR Adams ,NZ
2026,3,6,1,1,0,0,1,1 (1ct 0st),0.166,1985,1985,FS Ahangama ,SL
2027,7,14,1,1,0,0,1,1 (1ct 0st),0.071,2011,2012,Aizaz Cheema ,PAK
2028,5,8,1,1,0,0,1,1 (1ct 0st),0.125,1997,1998,Ali Naqvi ,PAK
2029,2,3,1,1,0,0,1,1 (1ct 0st),0.3329999999999999,1991,1991,IBA Allen ,WI
2030,2,2,1,1,0,0,1,1 (1ct 0st),0.5,1986,1988,KN Amalean ,SL
2031,1,2,1,1,0,0,1,1 (1ct 0st),0.5,1902,1902,JH Anderson ,SA
2032,9,16,1,1,0,0,1,1 (1ct 0st),0.062,1976,1978,RW Anderson ,NZ
2033,1,1,1,1,0,0,1,1 (1ct 0st),1.0,1946,1946,WM Anderson ,NZ
2034,2,3,1,1,0,1,0,1 (1ct 0st),0.3329999999999999,1954,1963,KV Andrew ,ENG
2035,2,3,1,1,0,0,1,1 (1ct 0st),0.3329999999999999,1973,1974,B Andrews ,NZ
2036,4,7,1,1,0,0,1,1 (1ct 0st),0.142,1993,1995,J Angel ,AUS
2037,3,6,1,1,0,0,1,1 (1ct 0st),0.166,2016,2016,ZS Ansari ,ENG
2038,7,13,1,1,0,0,1,1 (1ct 0st),0.076,2019,2019,JC Archer ,ENG
2039,18,28,1,1,0,0,1,1 (1ct 0st),0.035,1983,1985,Azeem Hafeez ,PAK
2040,7,10,1,1,0,0,1,1 (1ct 0st),0.1,1930,1933,FT Badcock ,NZ
2041,2,3,1,1,0,0,1,1 (1ct 0st),0.3329999999999999,2001,2001,SV Bahutule ,INDIA
2042,4,7,1,1,0,0,1,1 (1ct 0st),0.142,2008,2009,LS Baker ,WI
2043,8,15,1,1,0,0,1,1 (1ct 0st),0.066,2003,2005,L Balaji ,INDIA
2044,2,4,1,1,0,0,1,1 (1ct 0st),0.25,1976,1976,JC Balderstone ,ENG
2045,4,6,1,1,0,0,1,1 (1ct 0st),0.166,2016,2017,JT Ball ,ENG
2046,1,2,1,1,0,0,1,1 (1ct 0st),0.5,1956,1956,RT Barber ,NZ
2047,2,4,1,1,0,0,1,1 (1ct 0st),0.25,1935,1935,W Barber ,ENG
2048,4,8,1,1,0,0,1,1 (1ct 0st),0.125,1988,1989,KJ Barnett ,ENG
2049,2,4,1,1,0,0,1,1 (1ct 0st),0.25,1890,1890,JE Barrett ,AUS
2050,1,1,1,1,0,0,1,1 (1ct 0st),1.0,1913,1913,HV Baumgartner ,SA
2051,2,3,1,1,0,0,1,1 (1ct 0st),0.3329999999999999,2011,2012,MA Beer ,AUS
2052,2,4,1,1,0,0,1,1 (1ct 0st),0.25,1954,1954,W Bell ,NZ
2053,2,4,1,1,0,0,1,1 (1ct 0st),0.25,2018,2018,DM Bess ,ENG
2054,3,6,1,1,0,0,1,1 (1ct 0st),0.166,1955,1956,P Bhandari ,INDIA
2055,2,2,1,1,0,0,1,1 (1ct 0st),0.5,1959,1959,BA Bolton ,NZ
2056,3,6,1,1,0,0,1,1 (1ct 0st),0.166,1965,1965,JT Botten ,SA
2057,2,4,1,1,0,1,0,1 (1ct 0st),0.25,1889,1889,MP Bowden ,ENG
2058,6,11,1,1,0,0,1,1 (1ct 0st),0.09,1978,1985,BP Bracewell ,NZ
2059,9,16,1,1,0,0,1,1 (1ct 0st),0.062,1992,1995,DH Brain ,ZIM
2060,1,2,1,1,0,0,1,1 (1ct 0st),0.5,2002,2002,GR Breese ,WI
2061,2,4,1,0,1,0,0,1 (0ct 1st),0.25,1951,1951,DV Brennan ,ENG
2062,4,6,1,1,0,0,1,1 (1ct 0st),0.166,1999,2001,GB Brent ,ZIM
2063,2,3,1,1,0,0,1,1 (1ct 0st),0.3329999999999999,1935,1939,AW Briscoe ,SA
2064,4,8,1,1,0,0,1,1 (1ct 0st),0.125,1896,1899,HR Bromley-Davenport ,ENG
2065,1,2,1,1,0,0,1,1 (1ct 0st),0.5,1948,1948,D Brookes ,ENG
2066,2,4,1,1,0,0,1,1 (1ct 0st),0.25,1961,1961,A Brown ,ENG
2067,1,2,1,1,0,0,1,1 (1ct 0st),0.5,1996,1996,SJE Brown ,ENG
2068,4,6,1,1,0,0,1,1 (1ct 0st),0.166,1928,1930,CR Browne ,WI
2069,2,4,1,1,0,0,1,1 (1ct 0st),0.25,1958,1958,CGD Burger ,SA
2070,1,1,1,1,0,0,1,1 (1ct 0st),1.0,2017,2017,RP Burl ,ZIM
2071,3,5,1,1,0,0,1,1 (1ct 0st),0.2,1992,1992,MG Burmester ,ZIM
2072,1,2,1,1,0,0,1,1 (1ct 0st),0.5,1995,1995,IP Butchart ,ZIM
2073,2,4,1,1,0,0,1,1 (1ct 0st),0.25,1947,1948,HJ Butler ,ENG
2074,1,2,1,1,0,0,1,1 (1ct 0st),0.5,1978,1978,IW Callen ,AUS
2075,4,8,1,1,0,0,1,1 (1ct 0st),0.125,1989,1990,GD Campbell ,AUS
2076,4,8,1,1,0,0,1,1 (1ct 0st),0.125,1935,1949,GM Carew ,WI
2077,2,4,1,1,0,0,1,1 (1ct 0st),0.25,1914,1921,HW Chapman ,SA
2078,3,6,1,1,0,0,1,1 (1ct 0st),0.166,2006,2012,PP Chawla ,INDIA
2079,1,2,1,1,0,0,1,1 (1ct 0st),0.5,1970,1970,GA Chevalier ,SA
2080,2,3,1,1,0,0,1,1 (1ct 0st),0.3329999999999999,1988,1988,JH Childs ,ENG
2081,2,4,1,1,0,0,1,1 (1ct 0st),0.25,2003,2003,R Clarke ,ENG
2082,1,2,1,1,0,0,1,1 (1ct 0st),0.5,1935,1935,JC Clay ,ENG
2083,2,4,1,1,0,0,1,1 (1ct 0st),0.25,1927,1928,SK Coen ,SA
2084,7,14,1,1,0,0,1,1 (1ct 0st),0.071,1962,1964,LJ Coldwell ,ENG
2085,3,6,1,1,0,0,1,1 (1ct 0st),0.166,1972,1972,DJ Colley ,AUS
2086,12,19,1,1,0,0,1,1 (1ct 0st),0.052,1910,1928,JMM Commaille ,SA
2087,1,2,1,1,0,0,1,1 (1ct 0st),0.5,1923,1923,DP Conyngham ,SA
2088,1,1,1,1,0,0,1,1 (1ct 0st),1.0,1913,1913,AHC Cooper ,SA
2089,2,4,1,1,0,0,1,1 (1ct 0st),0.25,1881,1884,WH Cooper ,AUS
2090,3,5,1,1,0,0,1,1 (1ct 0st),0.2,1977,1978,GA Cope ,ENG
2091,3,6,1,1,0,0,1,1 (1ct 0st),0.166,1939,1947,WH Copson ,ENG
2092,1,2,1,1,0,0,1,1 (1ct 0st),0.5,1887,1887,JT Cottam ,AUS
2093,3,4,1,1,0,0,1,1 (1ct 0st),0.25,1913,1914,JL Cox ,SA
2094,1,2,1,1,0,0,1,1 (1ct 0st),0.5,1890,1890,J Cranston ,ENG
2095,4,8,1,1,0,0,1,1 (1ct 0st),0.125,1956,1956,WPA Crawford ,AUS
2096,5,7,1,1,0,0,1,1 (1ct 0st),0.142,1931,1932,IB Cromb ,NZ
2097,5,9,1,1,0,0,1,1 (1ct 0st),0.111,1993,1994,AC Cummins ,WI
2098,20,38,1,1,0,0,1,1 (1ct 0st),0.026,1964,1972,RS Cunis ,NZ
2099,3,4,1,1,0,0,1,1 (1ct 0st),0.25,2005,2005,KM Dabengwa ,ZIM
2100,6,12,1,1,0,0,1,1 (1ct 0st),0.083,2018,2019,A Dananjaya ,SL
2101,1,2,1,1,0,0,1,1 (1ct 0st),0.5,1952,1952,HT Dani ,INDIA
2102,4,7,1,1,0,0,1,1 (1ct 0st),0.142,1965,1965,BA Davis ,WI
2103,3,6,1,1,0,0,1,1 (1ct 0st),0.166,1930,1930,FI de Caires ,WI
2104,2,4,1,1,0,0,1,1 (1ct 0st),0.25,2011,2012,M de Lange ,SA
2105,5,9,1,1,0,0,1,1 (1ct 0st),0.111,1953,1954,EW Dempster ,NZ
2106,4,8,1,1,0,0,1,1 (1ct 0st),0.125,1999,2000,SI de Saram ,SL
2107,3,4,1,1,0,1,0,1 (1ct 0st),0.25,1997,1997,SKL de Silva ,SL
2108,3,6,1,1,0,0,1,1 (1ct 0st),0.166,2002,2007,WRS de Silva ,SL
2109,2,4,1,1,0,0,1,1 (1ct 0st),0.25,2009,2010,F de Wet ,SA
2110,4,8,1,1,0,0,1,1 (1ct 0st),0.125,1994,1996,R Dhanraj ,WI
2111,1,2,1,1,0,0,1,1 (1ct 0st),0.5,1914,1914,CD Dixon ,SA
2112,4,8,1,1,0,0,1,1 (1ct 0st),0.125,1947,1950,HE Dollery ,ENG
2113,1,2,1,1,0,1,0,1 (1ct 0st),0.5,1921,1921,A Dolphin ,ENG
2114,1,2,1,1,0,0,1,1 (1ct 0st),0.5,1921,1921,A Ducat ,ENG
2115,4,8,1,1,0,0,1,1 (1ct 0st),0.125,2016,2016,BM Duckett ,ENG
2116,2,3,1,1,0,0,1,1 (1ct 0st),0.3329999999999999,2005,2005,T Duffin ,ZIM
2117,2,3,1,1,0,0,1,1 (1ct 0st),0.3329999999999999,1889,1889,OR Dunell ,SA
2118,1,1,1,1,0,0,1,1 (1ct 0st),1.0,1892,1892,JF du Toit ,SA
2119,21,35,1,1,0,0,1,1 (1ct 0st),0.0279999999999999,1974,1980,G Dymock ,AUS
2120,4,4,1,1,0,0,1,1 (1ct 0st),0.25,2019,2019,Ebadat Hossain ,BDESH
2121,3,4,1,1,0,0,1,1 (1ct 0st),0.25,1888,1888,JD Edwards ,AUS
2122,4,7,1,1,0,0,1,1 (1ct 0st),0.142,2011,2013,Elias Sunny ,BDESH
2123,4,8,1,1,0,0,1,1 (1ct 0st),0.125,1998,2002,S Elworthy ,SA
2124,5,9,1,1,0,0,1,1 (1ct 0st),0.111,2019,2019,L Embuldeniya ,SL
2125,10,13,1,1,0,0,1,1 (1ct 0st),0.076,2001,2003,Enamul Haque ,BDESH
2126,3,4,1,1,0,0,1,1 (1ct 0st),0.25,1996,2003,CN Evans ,ZIM
2127,3,5,1,1,0,0,1,1 (1ct 0st),0.2,2003,2005,GM Ewing ,ZIM
2128,3,4,1,1,0,0,1,1 (1ct 0st),0.25,2002,2002,Fahim Muntasir ,BDESH
2129,15,27,1,1,0,0,1,1 (1ct 0st),0.037,1934,1939,K Farnes ,ENG
2130,2,3,1,1,0,0,1,1 (1ct 0st),0.3329999999999999,2002,2002,KHRK Fernando ,SL
2131,4,7,1,1,0,0,1,1 (1ct 0st),0.142,1936,1947,LB Fishlock ,ENG
2132,3,6,1,1,0,0,1,1 (1ct 0st),0.166,1972,1972,BC Francis ,AUS
2133,2,4,1,1,0,0,1,1 (1ct 0st),0.25,1899,1899,HH Francis ,SA
2134,3,4,1,1,0,0,1,1 (1ct 0st),0.25,1995,1995,JER Gallian ,ENG
2135,2,4,1,1,0,0,1,1 (1ct 0st),0.25,1969,1969,A Gandotra ,INDIA
2136,2,4,1,1,0,0,1,1 (1ct 0st),0.25,1948,1948,BBM Gaskin ,WI
2137,3,5,1,1,0,0,1,1 (1ct 0st),0.2,1958,1964,RA Gaunt ,AUS
2138,1,2,1,1,0,0,1,1 (1ct 0st),0.5,1955,1955,GL Gibbs ,WI
2139,3,5,1,1,0,0,1,1 (1ct 0st),0.2,1887,1892,WF Giffen ,AUS
2140,5,8,1,1,0,0,1,1 (1ct 0st),0.125,2007,2012,MR Gillespie ,NZ
2141,3,6,1,1,0,0,1,1 (1ct 0st),0.166,1936,1939,H Gimblett ,ENG
2142,5,8,1,1,0,0,1,1 (1ct 0st),0.125,1938,1939,N Gordon ,SA
2143,4,7,1,1,0,0,1,1 (1ct 0st),0.142,1936,1946,AR Gover ,ENG
2144,1,2,1,1,0,0,1,1 (1ct 0st),0.5,1880,1880,EM Grace ,ENG
2145,4,8,1,1,0,0,1,1 (1ct 0st),0.125,1959,1960,T Greenhough ,ENG
2146,1,2,1,1,0,0,1,1 (1ct 0st),0.5,1877,1877,EJ Gregory ,AUS
2147,2,4,1,1,0,0,1,1 (1ct 0st),0.25,1937,1937,RG Gregory ,AUS
2148,1,2,1,1,0,0,1,1 (1ct 0st),0.5,1930,1930,MG Grell ,WI
2149,3,6,1,1,0,0,1,1 (1ct 0st),0.166,1964,1964,CG Halse ,SA
2150,3,6,1,1,0,0,1,1 (1ct 0st),0.166,1947,1948,RA Hamence ,AUS
2151,5,10,1,1,0,0,1,1 (1ct 0st),0.1,1907,1908,J Hardstaff snr ,ENG
2152,5,8,1,1,0,0,1,1 (1ct 0st),0.125,2015,2015,SR Harmer ,SA
2153,3,6,1,1,0,0,1,1 (1ct 0st),0.166,1947,1949,TA Harris ,SA
2154,1,2,1,1,0,0,1,1 (1ct 0st),0.5,1895,1895,J Harry ,AUS
2155,2,4,1,1,0,0,1,1 (1ct 0st),0.25,1908,1908,MJ Hartigan ,AUS
2156,12,20,1,1,0,0,1,1 (1ct 0st),0.05,1958,1962,Haseeb Ahsan ,PAK
2157,3,5,1,1,0,0,1,1 (1ct 0st),0.2,2018,2019,Hashmatullah Shahidi ,AFG
2158,5,6,1,1,0,0,1,1 (1ct 0st),0.166,2000,2001,Hasibul Hossain ,BDESH
2159,1,2,1,1,0,0,1,1 (1ct 0st),0.5,2012,2012,JW Hastings ,AUS
2160,1,2,1,1,0,0,1,1 (1ct 0st),0.5,1892,1892,A Hearne ,ENG
2161,1,2,1,1,0,0,1,1 (1ct 0st),0.5,1930,1930,M Henderson ,NZ
2162,4,7,1,1,0,0,1,1 (1ct 0st),0.142,2013,2016,MC Henriques ,AUS
2163,1,2,1,1,0,0,1,1 (1ct 0st),0.5,1977,1977,PA Hibbert ,AUS
2164,2,4,1,1,0,0,1,1 (1ct 0st),0.25,1877,1877,A Hill ,ENG
2165,3,6,1,1,0,0,1,1 (1ct 0st),0.166,1896,1896,AJL Hill ,ENG
2166,4,6,1,1,0,0,1,1 (1ct 0st),0.166,1950,1952,MJ Hilton ,ENG
2167,4,5,1,1,0,0,1,1 (1ct 0st),0.2,1928,1933,ELG Hoad ,WI
2168,7,14,1,1,0,0,1,1 (1ct 0st),0.071,1996,2008,GB Hogg ,AUS
2169,4,8,1,1,0,0,1,1 (1ct 0st),0.125,2016,2018,JM Holland ,AUS
2170,2,2,1,1,0,0,1,1 (1ct 0st),0.5,1959,1959,KW Hough ,NZ
2171,1,2,1,1,0,0,1,1 (1ct 0st),0.5,1932,1932,WA Hunt ,AUS
2172,6,12,1,1,0,0,1,1 (1ct 0st),0.083,1935,1939,LG Hylton ,WI
2173,3,4,1,1,0,0,1,1 (1ct 0st),0.25,2016,2019,Iftikhar Ahmed ,PAK
2174,3,5,1,1,0,0,1,1 (1ct 0st),0.2,1989,1994,AP Igglesden ,ENG
2175,3,5,1,1,0,0,1,1 (1ct 0st),0.2,1953,1954,DEJ Ironside ,SA
2176,4,7,1,1,0,0,1,1 (1ct 0st),0.142,1952,1959,Israr Ali ,PAK
2177,2,4,1,1,0,0,1,1 (1ct 0st),0.25,1994,1995,SD Jack ,SA
2178,2,4,1,1,0,0,1,1 (1ct 0st),0.25,1949,1961,HL Jackson ,ENG
2179,1,1,1,1,0,0,1,1 (1ct 0st),1.0,1896,1896,CL Johnson ,SA
2180,1,2,1,1,0,0,1,1 (1ct 0st),0.5,1939,1939,TF Johnson ,WI
2181,1,2,1,1,0,0,1,1 (1ct 0st),0.5,2018,2018,EC Joyce ,IRE
2182,4,7,1,1,0,0,1,1 (1ct 0st),0.142,1994,1995,Kabir Khan ,PAK
2183,12,21,1,1,0,0,1,1 (1ct 0st),0.047,2010,2012,S Randiv ,SL
2184,4,7,1,1,0,0,1,1 (1ct 0st),0.142,1994,1996,AR Kapoor ,INDIA
2185,1,2,1,1,0,1,0,1 (1ct 0st),0.5,2000,2000,SS Karim ,INDIA
2186,1,2,1,1,0,0,1,1 (1ct 0st),0.5,2019,2019,C Karunaratne ,SL
2187,2,4,1,1,0,0,1,1 (1ct 0st),0.25,1877,1879,TJD Kelly ,AUS
2188,5,8,1,1,0,0,1,1 (1ct 0st),0.125,1958,1960,RB Kenny ,INDIA
2189,2,4,1,1,0,0,1,1 (1ct 0st),0.25,1948,1954,ESM Kentish ,WI
2190,2,4,1,1,0,0,1,1 (1ct 0st),0.25,1985,1985,RB Kerr ,AUS
2191,1,2,1,1,0,0,1,1 (1ct 0st),0.5,2009,2009,I Khan ,SA
2192,5,5,1,1,0,0,1,1 (1ct 0st),0.2,1947,1952,G Kishenchand ,INDIA
2193,3,6,1,1,0,0,1,1 (1ct 0st),0.166,1904,1904,AE Knight ,ENG
2194,2,4,1,1,0,0,1,1 (1ct 0st),0.25,1921,1921,DJ Knight ,ENG
2195,2,4,1,1,0,0,1,1 (1ct 0st),0.25,1988,1988,CM Kuggeleijn ,NZ
2196,4,8,1,1,0,0,1,1 (1ct 0st),0.125,2017,2017,HG Kuhn ,SA
2197,1,2,1,1,0,0,1,1 (1ct 0st),0.5,1992,1992,AP Kuiper ,SA
2198,3,3,1,1,0,0,1,1 (1ct 0st),0.3329999999999999,1997,2001,NM Kulkarni ,INDIA
2199,3,6,1,1,0,0,1,1 (1ct 0st),0.166,1986,1987,RR Kulkarni ,INDIA
2200,4,6,1,1,0,1,0,1 (1ct 0st),0.166,1987,1991,DSBP Kuruppu ,SL
2201,2,4,1,1,0,0,1,1 (1ct 0st),0.25,2002,2002,MKGCP Lakshitha ,SL
2202,1,2,1,1,0,0,1,1 (1ct 0st),0.5,1932,1932,Lall Singh ,INDIA
2203,1,2,1,1,0,0,1,1 (1ct 0st),0.5,1995,1995,SG Law ,AUS
2204,2,4,1,1,0,0,1,1 (1ct 0st),0.25,1931,1933,PK Lee ,AUS
2205,5,8,1,1,0,0,1,1 (1ct 0st),0.125,1927,1930,GB Legge ,ENG
2206,4,8,1,1,0,0,1,1 (1ct 0st),0.125,1882,1883,CFH Leslie ,ENG
2207,3,6,1,1,0,0,1,1 (1ct 0st),0.166,1910,1910,HDG Leveson Gower ,ENG
2208,2,2,1,1,0,0,1,1 (1ct 0st),0.5,2018,2018,SH Lewis ,WI
2209,5,7,1,1,0,0,1,1 (1ct 0st),0.142,1975,1978,Liaqat Ali ,PAK
2210,5,10,1,1,0,0,1,1 (1ct 0st),0.1,1998,1998,GFJ Liebenberg ,SA
2211,2,4,1,1,0,0,1,1 (1ct 0st),0.25,1877,1877,James Lillywhite jnr ,ENG
2212,1,2,1,1,0,0,1,1 (1ct 0st),0.5,1921,1921,NV Lindsay ,SA
2213,6,12,1,1,0,0,1,1 (1ct 0st),0.083,1921,1923,WVS Ling ,SA
2214,2,2,1,1,0,0,1,1 (1ct 0st),0.5,1956,1956,AF Lissette ,NZ
2215,4,7,1,1,0,0,1,1 (1ct 0st),0.142,2003,2004,KS Lokuarachchi ,SL
2216,5,9,1,1,0,0,1,1 (1ct 0st),0.111,1879,1884,AP Lucas ,ENG
2217,3,5,1,1,0,0,1,1 (1ct 0st),0.2,1993,1994,MJ McCague ,ENG
2218,2,4,1,1,0,0,1,1 (1ct 0st),0.25,1902,1902,CP McGahey ,ENG
2219,1,1,1,1,0,0,1,1 (1ct 0st),1.0,1886,1886,J McIlwraith ,AUS
2220,1,2,1,1,0,0,1,1 (1ct 0st),0.5,2009,2009,CJ McKay ,AUS
2221,8,16,1,1,0,0,1,1 (1ct 0st),0.062,1960,1967,AH McKinnon ,SA
2222,3,6,1,1,0,0,1,1 (1ct 0st),0.166,1998,2000,TN Madondo ,ZIM
2223,10,15,1,1,0,0,1,1 (1ct 0st),0.066,2002,2005,NB Mahwire ,ZIM
2224,2,2,1,1,0,0,1,1 (1ct 0st),0.5,2004,2004,A Maregwede ,ZIM
2225,1,2,1,1,0,0,1,1 (1ct 0st),0.5,1933,1933,CS Marriott ,ENG
2226,13,23,1,1,0,0,1,1 (1ct 0st),0.043,2000,2006,HJH Marshall ,NZ
2227,4,8,1,1,0,0,1,1 (1ct 0st),0.125,1951,1952,RE Marshall ,WI
2228,1,2,1,1,0,0,1,1 (1ct 0st),0.5,2013,2013,T Maruma ,ZIM
2229,1,2,1,1,0,0,1,1 (1ct 0st),0.5,2018,2018,WP Masakadza ,ZIM
2230,6,12,1,1,0,0,1,1 (1ct 0st),0.083,1972,1973,RAL Massie ,AUS
2231,1,2,1,1,0,0,1,1 (1ct 0st),0.5,1937,1937,ADG Matthews ,ENG
2232,3,6,1,1,0,0,1,1 (1ct 0st),0.166,1986,1988,CD Matthews ,AUS
2233,1,2,1,1,0,0,1,1 (1ct 0st),0.5,1899,1899,W Mead ,ENG
2234,1,1,1,1,0,1,0,1 (1ct 0st),1.0,1936,1936,KR Meherhomji ,INDIA
2235,8,16,1,1,0,0,1,1 (1ct 0st),0.062,1955,1964,VL Mehra ,INDIA
2236,2,2,1,1,0,0,1,1 (1ct 0st),0.5,1933,1933,CA Merry ,WI
2237,1,2,1,1,0,0,1,1 (1ct 0st),0.5,1946,1946,KD Meuleman ,AUS
2238,2,4,1,1,0,0,1,1 (1ct 0st),0.25,1996,1996,PL Mhambrey ,INDIA
2239,6,11,1,1,0,0,1,1 (1ct 0st),0.09,1896,1902,J Middleton ,SA
2240,13,20,1,1,0,0,1,1 (1ct 0st),0.05,1953,1958,LSM Miller ,NZ
2241,2,4,1,1,0,0,1,1 (1ct 0st),0.25,1899,1899,FW Milligan ,ENG
2242,1,1,1,1,0,0,1,1 (1ct 0st),1.0,1892,1892,CH Mills ,SA
2243,7,10,1,1,0,0,1,1 (1ct 0st),0.1,1930,1933,JE Mills ,NZ
2244,5,9,1,1,0,0,1,1 (1ct 0st),0.111,1933,1935,TB Mitchell ,ENG
2245,1,2,1,1,0,0,1,1 (1ct 0st),0.5,2012,2012,Mohammad Ayub ,PAK
2246,7,11,1,1,0,0,1,1 (1ct 0st),0.09,1960,1965,Mohammad Farooq ,PAK
2247,2,3,1,1,0,0,1,1 (1ct 0st),0.3329999999999999,1996,1998,Mohammad Hussain ,PAK
2248,1,1,1,1,0,0,1,1 (1ct 0st),1.0,1997,1997,Mohammad Ramzan ,PAK
2249,4,6,1,1,0,0,1,1 (1ct 0st),0.166,2009,2014,Mohammad Talha ,PAK
2250,5,10,1,1,0,0,1,1 (1ct 0st),0.1,2004,2006,D Mohammed ,WI
2251,3,5,1,1,0,0,1,1 (1ct 0st),0.2,1893,1893,AW Mold ,ENG
2252,1,1,1,1,0,0,1,1 (1ct 0st),1.0,1963,1963,BD Morrison ,NZ
2253,2,4,1,1,0,0,1,1 (1ct 0st),0.25,1990,1990,EA Moseley ,WI
2254,6,12,1,1,0,0,1,1 (1ct 0st),0.083,1887,1895,H Moses ,AUS
2255,9,17,1,1,0,0,1,1 (1ct 0st),0.0579999999999999,1954,1960,AE Moss ,ENG
2256,1,2,1,1,0,0,1,1 (1ct 0st),0.5,1880,1880,WH Moule ,AUS
2257,1,2,1,1,0,0,1,1 (1ct 0st),0.5,1965,1965,Mufasir-ul-Haq ,PAK
2258,2,4,1,1,0,0,1,1 (1ct 0st),0.25,2016,2016,CT Mumba ,ZIM
2259,3,4,1,1,0,0,1,1 (1ct 0st),0.25,1959,1962,Munir Malik ,PAK
2260,13,21,1,1,0,0,1,1 (1ct 0st),0.047,2015,2019,Mustafizur Rahman ,BDESH
2261,1,2,1,1,0,0,1,1 (1ct 0st),0.5,2019,2019,S Nadeem ,INDIA
2262,2,4,1,1,0,0,1,1 (1ct 0st),0.25,2013,2013,Nasir Jamshed ,PAK
2263,2,4,1,1,0,1,0,1 (1ct 0st),0.25,1932,1933,JG Navle ,INDIA
2264,2,3,1,1,0,0,1,1 (1ct 0st),0.3329999999999999,1982,1982,SV Nayak ,INDIA
2265,4,7,1,1,0,0,1,1 (1ct 0st),0.142,2018,2019,Nayeem Hasan ,BDESH
2266,3,5,1,1,0,0,1,1 (1ct 0st),0.2,2011,2012,Nazimuddin ,BDESH
2267,1,2,1,1,0,0,1,1 (1ct 0st),0.5,2011,2011,N Ncube ,ZIM
2268,6,10,1,1,0,0,1,1 (1ct 0st),0.1,1949,1957,JD Nel ,SA
2269,3,6,1,1,0,0,1,1 (1ct 0st),0.166,1988,1991,PJ Newport ,ENG
2270,3,5,1,1,0,0,1,1 (1ct 0st),0.2,2000,2001,M Ngam ,SA
2271,2,4,1,1,0,0,1,1 (1ct 0st),0.25,1967,1969,Niaz Ahmed ,PAK
2272,3,6,1,1,0,0,1,1 (1ct 0st),0.166,1950,1953,G Noblet ,AUS
2273,3,6,1,1,0,0,1,1 (1ct 0st),0.166,1928,1929,AL Ochse ,SA
2274,2,4,1,1,0,0,1,1 (1ct 0st),0.25,2002,2004,JL Ontong ,SA
2275,4,6,1,1,0,0,1,1 (1ct 0st),0.166,2017,2019,C Overton ,ENG
2276,3,5,1,1,0,0,1,1 (1ct 0st),0.2,1953,1954,GWF Overton ,NZ
2277,1,2,1,1,0,0,1,1 (1ct 0st),0.5,1927,1928,AW Palm ,SA
2278,2,3,1,1,0,0,1,1 (1ct 0st),0.3329999999999999,2008,2008,BA Parchment ,WI
2279,1,2,1,1,0,0,1,1 (1ct 0st),0.5,1982,1982,GAHM Parkar ,INDIA
2280,1,1,1,1,0,0,1,1 (1ct 0st),1.0,1892,1892,DC Parkin ,SA
2281,2,2,1,1,0,0,1,1 (1ct 0st),0.5,2010,2010,NT Pascal ,WI
2282,1,2,1,1,0,0,1,1 (1ct 0st),0.5,1988,1988,RGM Patel ,INDIA
2283,1,2,1,1,0,0,1,1 (1ct 0st),0.5,1955,1955,SR Patil ,INDIA
2284,4,7,1,1,0,0,1,1 (1ct 0st),0.142,1993,1994,SG Peall ,ZIM
2285,3,5,1,1,0,0,1,1 (1ct 0st),0.2,1910,1911,COC Pearse ,SA
2286,3,6,1,1,0,0,1,1 (1ct 0st),0.166,1998,2001,ASA Perera ,SL
2287,6,9,1,1,0,0,1,1 (1ct 0st),0.111,2011,2012,NLTC Perera ,SL
2288,2,3,1,1,0,0,1,1 (1ct 0st),0.3329999999999999,1939,1939,RTD Perks ,ENG
2289,4,7,1,1,0,0,1,1 (1ct 0st),0.142,1999,1999,NO Perry ,WI
2290,2,4,1,1,0,0,1,1 (1ct 0st),0.25,2009,2009,OJ Phillips ,WI
2291,3,5,1,1,0,0,1,1 (1ct 0st),0.2,1951,1952,CJ Poole ,ENG
2292,14,20,1,1,0,0,1,1 (1ct 0st),0.05,1953,1956,MB Poore ,NZ
2293,2,4,1,1,0,0,1,1 (1ct 0st),0.25,1999,2004,RL Powell ,WI
2294,1,2,1,1,0,0,1,1 (1ct 0st),0.5,2019,2019,D Pretorius ,SA
2295,3,5,1,1,0,0,1,1 (1ct 0st),0.2,1966,1966,N Puna ,NZ
2296,12,19,1,1,0,0,1,1 (1ct 0st),0.052,1929,1932,NA Quinn ,SA
2297,2,4,1,1,0,0,1,1 (1ct 0st),0.25,1985,1985,LS Rajput ,INDIA
2298,1,2,1,1,0,0,1,1 (1ct 0st),0.5,1933,1933,L Ramji ,INDIA
2299,3,4,1,1,0,0,1,1 (1ct 0st),0.25,1947,1948,KM Rangnekar ,INDIA
2300,7,14,1,1,0,0,1,1 (1ct 0st),0.071,1958,1964,VB Ranjane ,INDIA
2301,1,2,1,1,0,0,1,1 (1ct 0st),0.5,2000,2000,Ranjan Das ,BDESH
2302,22,32,1,1,0,0,1,1 (1ct 0st),0.031,1982,1989,JR Ratnayeke ,SL
2303,1,2,1,1,0,0,1,1 (1ct 0st),0.5,1894,1894,JC Reedman ,AUS
2304,3,6,1,1,0,0,1,1 (1ct 0st),0.166,1992,1992,DA Reeve ,ENG
2305,1,1,1,1,0,0,1,1 (1ct 0st),1.0,1949,1949,MR Rege ,INDIA
2306,1,2,1,1,0,0,1,1 (1ct 0st),0.5,1958,1958,SF Rehman ,PAK
2307,4,8,1,1,0,0,1,1 (1ct 0st),0.125,1993,1997,JA Rennie ,ZIM
2308,9,14,1,1,0,0,1,1 (1ct 0st),0.071,1924,1926,AJ Richardson ,AUS
2309,1,2,1,1,0,0,1,1 (1ct 0st),0.5,1957,1957,DW Richardson ,ENG
2310,4,7,1,1,0,0,1,1 (1ct 0st),0.142,1998,1998,GR Robertson ,AUS
2311,1,2,1,1,0,0,1,1 (1ct 0st),0.5,1936,1936,RH Robinson ,AUS
2312,4,6,1,1,0,0,1,1 (1ct 0st),0.166,2005,2005,BG Rogers ,ZIM
2313,3,3,1,1,0,0,1,1 (1ct 0st),0.3329999999999999,1926,1926,CF Root ,ENG
2314,4,8,1,1,0,0,1,1 (1ct 0st),0.125,1959,1959,GF Rorke ,AUS
2315,1,1,1,1,0,0,1,1 (1ct 0st),1.0,1946,1946,CG Rowe ,NZ
2316,5,10,1,1,0,0,1,1 (1ct 0st),0.1,2019,2019,JJ Roy ,ENG
2317,2,2,1,1,0,0,1,1 (1ct 0st),0.5,1982,1982,P Roy ,INDIA
2318,1,2,1,1,0,0,1,1 (1ct 0st),0.5,2010,2010,AD Russell ,WI
2319,3,6,1,1,0,0,1,1 (1ct 0st),0.166,2003,2004,MJ Saggers ,ENG
2320,1,2,1,1,0,0,1,1 (1ct 0st),0.5,1910,1910,SV Samuelson ,SA
2321,8,11,1,1,0,0,1,1 (1ct 0st),0.09,1983,1983,BS Sandhu ,INDIA
2322,9,11,1,1,0,0,1,1 (1ct 0st),0.09,2001,2003,Sanwar Hossain ,BDESH
2323,3,5,1,1,0,0,1,1 (1ct 0st),0.2,2000,2002,Sarandeep Singh ,INDIA
2324,1,2,1,1,0,0,1,1 (1ct 0st),0.5,2018,2018,CJ Sayers ,AUS
2325,1,1,1,1,0,0,1,1 (1ct 0st),1.0,1896,1896,AW Seccull ,SA
2326,6,11,1,1,0,1,0,1 (1ct 0st),0.09,1877,1882,J Selby ,ENG
2327,1,1,1,1,0,0,1,1 (1ct 0st),1.0,1964,1964,RHD Sellers ,AUS
2328,3,6,1,1,0,0,1,1 (1ct 0st),0.166,1976,1977,MWW Selvey ,ENG
2329,1,2,1,1,0,0,1,1 (1ct 0st),0.5,2013,2014,SMSM Senanayake ,SL
2330,7,13,1,1,0,0,1,1 (1ct 0st),0.076,1950,1963,D Shackleton ,ENG
2331,5,9,1,1,0,0,1,1 (1ct 0st),0.111,2017,2019,Shadab Khan ,PAK
2332,3,5,1,0,1,0,0,1 (0ct 1st),0.2,2000,2004,Shahriar Hossain ,BDESH
2333,1,2,1,1,0,0,1,1 (1ct 0st),0.5,1998,1998,Shakeel Ahmed snr ,PAK
2334,3,4,1,1,0,0,1,1 (1ct 0st),0.25,2016,2017,MD Shanaka ,SL
2335,1,2,1,1,0,0,1,1 (1ct 0st),0.5,1988,1988,AK Sharma ,INDIA
2336,5,7,1,1,0,0,1,1 (1ct 0st),0.142,1974,1977,PH Sharma ,INDIA
2337,2,4,1,1,0,0,1,1 (1ct 0st),0.25,1988,1990,SK Sharma ,INDIA
2338,3,6,1,1,0,0,1,1 (1ct 0st),0.166,1909,1909,J Sharp ,ENG
2339,4,8,1,1,0,0,1,1 (1ct 0st),0.125,1977,1978,IT Shillingford ,WI
2340,3,6,1,1,0,0,1,1 (1ct 0st),0.166,1952,1953,RH Shodhan ,INDIA
2341,5,9,1,1,0,0,1,1 (1ct 0st),0.111,1970,1971,K Shuttleworth ,ENG
2342,1,2,1,1,0,0,1,1 (1ct 0st),0.5,2001,2001,IR Siddiqui ,INDIA
2343,7,12,1,1,0,0,1,1 (1ct 0st),0.083,1995,1998,KJ Silva ,SL
2344,5,10,1,1,0,0,1,1 (1ct 0st),0.1,1910,1910,GHT Simpson-Hayward ,ENG
2345,2,3,1,1,0,0,1,1 (1ct 0st),0.3329999999999999,1956,1956,IM Sinclair ,NZ
2346,1,2,1,1,0,0,1,1 (1ct 0st),0.5,1999,1999,R Singh ,INDIA
2347,5,10,1,1,0,0,1,1 (1ct 0st),0.1,2006,2007,VRV Singh ,INDIA
2348,5,9,1,1,0,0,1,1 (1ct 0st),0.111,1935,1937,CIJ Smith ,ENG
2349,2,4,1,1,0,0,1,1 (1ct 0st),0.25,1935,1935,D Smith ,ENG
2350,4,7,1,1,0,0,1,1 (1ct 0st),0.142,1947,1952,FB Smith ,NZ
2351,1,2,1,1,0,1,0,1 (1ct 0st),0.5,1928,1928,H Smith ,ENG
2352,3,6,1,1,0,0,1,1 (1ct 0st),0.166,1984,1984,SB Smith ,AUS
2353,4,5,1,1,0,0,1,1 (1ct 0st),0.2,1946,1947,TPB Smith ,ENG
2354,5,9,1,1,0,0,1,1 (1ct 0st),0.111,1992,1994,RP Snell ,SA
2355,1,2,1,1,0,0,1,1 (1ct 0st),0.5,1899,1899,WRT Solomon ,SA
2356,3,4,1,1,0,0,1,1 (1ct 0st),0.25,1928,1930,WH St Hill ,WI
2357,6,11,1,1,0,0,1,1 (1ct 0st),0.09,1984,1986,DA Stirling ,NZ
2358,11,19,1,1,0,0,1,1 (1ct 0st),0.052,2017,2018,MD Stoneman ,ENG
2359,1,1,1,0,1,0,0,1 (0ct 1st),1.0,1923,1923,GB Street ,ENG
2360,2,4,1,1,0,0,1,1 (1ct 0st),0.25,2000,2000,PC Strydom ,SA
2361,5,5,1,1,0,0,1,1 (1ct 0st),0.2,1924,1924,MJ Susskind ,SA
2362,3,6,1,1,0,0,1,1 (1ct 0st),0.166,2005,2008,SW Tait ,AUS
2363,7,9,1,1,0,0,1,1 (1ct 0st),0.111,2002,2004,Talha Jubair ,BDESH
2364,5,10,1,1,0,0,1,1 (1ct 0st),0.1,2010,2013,Tanvir Ahmed ,PAK
2365,1,1,1,1,0,0,1,1 (1ct 0st),1.0,1913,1913,GL Tapscott ,SA
2366,3,4,1,1,0,0,1,1 (1ct 0st),0.25,2004,2004,Tareq Aziz ,BDESH
2367,5,10,1,1,0,0,1,1 (1ct 0st),0.1,2017,2017,Taskin Ahmed ,BDESH
2368,3,6,1,1,0,0,1,1 (1ct 0st),0.166,1959,1964,K Taylor ,ENG
2369,2,4,1,1,0,0,1,1 (1ct 0st),0.25,1985,1985,LB Taylor ,ENG
2370,1,2,1,1,0,0,1,1 (1ct 0st),0.5,1902,1902,G Thornton ,SA
2371,3,5,1,1,0,0,1,1 (1ct 0st),0.2,1935,1935,DCH Townsend ,ENG
2372,1,2,1,1,0,0,1,1 (1ct 0st),0.5,1902,1902,JPF Travers ,AUS
2373,1,2,1,1,0,0,1,1 (1ct 0st),0.5,1965,1965,PB Truscott ,NZ
2374,5,9,1,1,0,0,1,1 (1ct 0st),0.111,2010,2011,LL Tsotsobe ,SA
2375,1,2,1,0,1,0,0,1 (0ct 1st),0.5,1910,1910,NC Tufnell ,ENG
2376,9,17,1,1,0,0,1,1 (1ct 0st),0.0579999999999999,1930,1936,MJL Turnbull ,ENG
2377,5,6,1,1,0,0,1,1 (1ct 0st),0.166,2002,2007,Tushar Imran ,BDESH
2378,7,11,1,1,0,0,1,1 (1ct 0st),0.09,1924,1930,RK Tyldesley ,ENG
2379,4,7,1,1,0,0,1,1 (1ct 0st),0.142,2005,2006,SD Udal ,ENG
2380,4,8,1,1,0,0,1,1 (1ct 0st),0.125,2010,2010,Umar Amin ,PAK
2381,5,8,1,1,0,0,1,1 (1ct 0st),0.125,1938,1939,PGV van der Bijl ,SA
2382,1,2,1,1,0,0,1,1 (1ct 0st),0.5,2019,2019,HE van der Dussen ,SA
2383,1,2,1,1,0,0,1,1 (1ct 0st),0.5,1989,1989,M Venkataramana ,INDIA
2384,7,14,1,1,0,0,1,1 (1ct 0st),0.071,2018,2019,GH Vihari ,INDIA
2385,2,3,1,1,0,0,1,1 (1ct 0st),0.3329999999999999,1998,2000,DP Viljoen ,ZIM
2386,3,4,1,1,0,0,1,1 (1ct 0st),0.25,1889,1892,CH Vintcent ,SA
2387,3,5,1,1,0,0,1,1 (1ct 0st),0.2,1936,1936,Vizianagram ,INDIA
2388,2,4,1,1,0,0,1,1 (1ct 0st),0.25,1920,1921,A Waddington ,ENG
2389,2,3,1,1,0,0,1,1 (1ct 0st),0.3329999999999999,1938,1938,MG Waite ,AUS
2390,2,4,1,1,0,0,1,1 (1ct 0st),0.25,1996,1996,AC Waller ,ZIM
2391,7,13,1,1,0,0,1,1 (1ct 0st),0.076,1893,1895,A Ward ,ENG
2392,4,6,1,1,0,0,1,1 (1ct 0st),0.166,1936,1938,FA Ward ,AUS
2393,5,9,1,1,0,0,1,1 (1ct 0st),0.111,2001,2001,IJ Ward ,ENG
2394,1,2,1,1,0,0,1,1 (1ct 0st),0.5,1905,1905,A Warren ,ENG
2395,4,7,1,1,0,0,1,1 (1ct 0st),0.142,1990,1990,AS Wassan ,INDIA
2396,3,6,1,1,0,0,1,1 (1ct 0st),0.166,1991,1993,SL Watkin ,ENG
2397,1,2,1,1,0,0,1,1 (1ct 0st),0.5,1973,1973,JR Watkins ,AUS
2398,4,7,1,1,0,0,1,1 (1ct 0st),0.142,1995,1996,M Watkinson ,ENG
2399,7,14,1,1,0,0,1,1 (1ct 0st),0.071,1960,1962,CD Watson ,WI
2400,5,9,1,1,0,0,1,1 (1ct 0st),0.111,1966,1972,GD Watson ,AUS
2401,7,13,1,1,0,0,1,1 (1ct 0st),0.076,1932,1936,S Wazir Ali ,INDIA
2402,3,5,1,1,0,0,1,1 (1ct 0st),0.2,1960,1960,C Wesley ,SA
2403,5,10,1,1,0,0,1,1 (1ct 0st),0.1,2017,2017,T Westley ,ENG
2404,1,2,1,1,0,0,1,1 (1ct 0st),0.5,1986,1986,JJ Whitaker ,ENG
2405,2,3,1,1,0,0,1,1 (1ct 0st),0.3329999999999999,1965,1965,AW White ,WI
2406,4,8,1,1,0,0,1,1 (1ct 0st),0.125,2008,2008,CL White ,AUS
2407,4,6,1,1,0,0,1,1 (1ct 0st),0.166,1982,1985,RGCE Wijesuriya ,SL
2408,6,12,1,1,0,0,1,1 (1ct 0st),0.083,1964,1971,D Wilson ,ENG
2409,5,8,1,1,0,0,1,1 (1ct 0st),0.125,1950,1955,PL Winslow ,SA
2410,1,2,1,1,0,0,1,1 (1ct 0st),0.5,1974,1974,AJ Woodcock ,AUS
2411,4,8,1,1,0,0,1,1 (1ct 0st),0.125,2016,2017,J Yadav ,INDIA
2412,3,6,1,1,0,0,1,1 (1ct 0st),0.166,2001,2002,T Yohannan ,INDIA
2413,2,4,1,1,0,0,1,1 (1ct 0st),0.25,1899,1899,HI Young ,ENG
2414,2,4,1,1,0,0,1,1 (1ct 0st),0.25,1996,1996,Zahoor Elahi ,PAK
2415,2,4,1,1,0,0,1,1 (1ct 0st),0.25,1986,1989,Zakir Khan ,PAK
2416,6,11,1,1,0,0,1,1 (1ct 0st),0.09,2003,2008,M Zondeki ,SA
2417,3,6,0,0,0,0,0,0,0.0,2009,2009,Abdur Rauf ,PAK
2418,2,3,0,0,0,0,0,0,0.0,2019,2019,Abid Ali ,PAK
2419,1,2,0,0,0,0,0,0,0.0,1879,1879,CA Absolom ,ENG
2420,2,4,0,0,0,0,0,0,0.0,1969,1975,Aftab Baloch ,PAK
2421,3,4,0,0,0,0,0,0,0.0,2001,2001,U Afzaal ,ENG
2422,4,8,0,0,0,0,0,0,0.0,2013,2017,AC Agar ,AUS
2423,1,2,0,0,0,0,0,0,0.0,1975,1975,Agha Zahid ,PAK
2424,3,6,0,0,0,0,0,0,0.0,1984,1985,JP Agnew ,ENG
2425,3,4,0,0,0,0,0,0,0.0,2002,2004,Alamgir Kabir ,BDESH
2426,1,2,0,0,0,0,0,0,0.0,1933,1933,HH Alexander ,AUS
2427,1,2,0,0,0,0,0,0,0.0,1976,1976,Imtiaz Ali ,WI
2428,1,2,0,0,0,0,0,0,0.0,2003,2003,Kabir Ali ,ENG
2429,1,1,0,0,0,0,0,0,0.0,1997,1997,Ali Hussain Rizvi ,PAK
2430,1,2,0,0,0,0,0,0,0.0,1879,1879,FE Allan ,AUS
2431,1,2,0,0,0,0,0,0,0.0,1965,1965,PJ Allan ,AUS
2432,5,8,0,0,0,0,0,0,0.0,1930,1931,MJC Allom ,ENG
2433,7,11,0,0,0,0,0,0,0.0,2013,2019,Al-Amin Hossain ,BDESH
2434,1,2,0,0,0,0,0,0,0.0,2008,2008,MKDI Amerasinghe ,SL
2435,6,9,0,0,0,0,0,0,0.0,1947,1952,Amir Elahi ,INDIA
2436,1,2,0,0,0,0,0,0,0.0,2019,2019,Amir Hamza ,AFG
2437,1,2,0,0,0,0,0,0,0.0,1989,1989,SA Ankola ,INDIA
2438,3,3,0,0,0,0,0,0,0.0,2003,2005,Anwar Hossain Monir ,BDESH
2439,1,1,0,0,0,0,0,0,0.0,2002,2002,Anwar Hossain ,BDESH
2440,4,6,0,0,0,0,0,0,0.0,1952,1952,Anwar Hussain ,PAK
2441,1,2,0,0,0,0,0,0,0.0,1979,1979,Anwar Khan ,PAK
2442,1,1,0,0,0,0,0,0,0.0,1959,1959,AL Apte ,INDIA
2443,1,2,0,0,0,0,0,0,0.0,1899,1899,AG Archer ,ENG
2444,5,10,0,0,0,0,0,0,0.0,1950,1951,KA Archer ,AUS
2445,3,6,0,0,0,0,0,0,0.0,1964,1965,Arif Butt ,PAK
2446,2,4,0,0,0,0,0,0,0.0,1877,1877,T Armitage ,ENG
2447,1,2,0,0,0,0,0,0,0.0,1931,1931,J Arnold ,ENG
2448,9,17,0,0,0,0,0,0,0.0,1997,2005,Arshad Khan ,PAK
2449,2,2,0,0,0,0,0,0,0.0,1957,1957,NS Asgarali ,WI
2450,1,2,0,0,0,0,0,0,0.0,1993,1993,Ashfaq Ahmed ,PAK
2451,1,1,0,0,0,0,0,0,0.0,1889,1889,WH Ashley ,SA
2452,1,2,0,0,0,0,0,0,0.0,1994,1994,Atif Rauf ,PAK
2453,1,2,0,0,0,0,0,0,0.0,1996,1996,Azam Khan ,PAK
2454,1,2,0,0,0,0,0,0,0.0,1980,1980,Azhar Khan ,PAK
2455,1,2,0,0,0,0,0,0,0.0,1980,1980,Azmat Rana ,PAK
2456,4,7,0,0,0,0,0,0,0.0,1988,1990,RJ Bailey ,ENG
2457,7,14,0,0,0,0,0,0,0.0,1998,2001,MRCN Bandaratilleke ,SL
2458,1,2,0,0,0,0,0,0,0.0,1949,1949,SN Banerjee ,INDIA
2459,1,2,0,0,0,0,0,0,0.0,1992,1992,ST Banerjee ,INDIA
2460,3,6,0,0,0,0,0,0,0.0,1877,1879,C Bannerman ,AUS
2461,1,2,0,0,0,0,0,0,0.0,1936,1936,M Baqa Jilani ,INDIA
2462,3,6,0,0,0,0,0,0,0.0,1976,1977,GD Barlow ,ENG
2463,6,10,0,0,0,0,0,0,0.0,1971,1975,AG Barrett ,WI
2464,1,2,0,0,0,0,0,0,0.0,1892,1892,VA Barton ,ENG
2465,3,4,0,0,0,0,0,0,0.0,1980,1980,GR Beard ,AUS
2466,8,14,0,0,0,0,0,0,0.0,1953,1956,JEF Beck ,NZ
2467,3,6,0,0,0,0,0,0,0.0,1972,1973,J Benaud ,AUS
2468,1,2,0,0,0,0,0,0,0.0,1994,1994,JE Benjamin ,ENG
2469,1,2,0,0,0,0,0,0,0.0,2010,2010,HK Bennett ,NZ
2470,1,2,0,0,0,0,0,0,0.0,1986,1986,MR Benson ,ENG
2471,3,6,0,0,0,0,0,0,0.0,2003,2009,DE Bernard ,WI
2472,1,2,0,0,0,0,0,0,0.0,2010,2010,BJ Bess ,WI
2473,1,2,0,0,0,0,0,0,0.0,1930,1930,N Betancourt ,WI
2474,2,3,0,0,0,0,0,0,0.0,1983,1983,AR Bhat ,INDIA
2475,2,4,0,0,0,0,0,0,0.0,2013,2014,Bilawal Bhatti ,PAK
2476,4,8,0,0,0,0,0,0,0.0,1927,1928,GF Bissett ,SA
2477,6,10,0,0,0,0,0,0,0.0,2000,2002,MI Black ,WI
2478,1,2,0,0,0,0,0,0,0.0,2006,2006,ID Blackwell ,ENG
2479,1,2,0,0,0,0,0,0,0.0,1935,1935,EG Bock ,SA
2480,1,2,0,0,0,0,0,0,0.0,1938,1938,GE Bond ,SA
2481,2,4,0,0,0,0,0,0,0.0,1913,1914,MW Booth ,ENG
2482,1,2,0,0,0,0,0,0,0.0,1992,1992,T Bosch ,SA
2483,2,4,0,0,0,0,0,0,0.0,1899,1899,WM Bradley ,ENG
2484,3,4,0,0,0,0,0,0,0.0,2015,2016,CR Brathwaite ,WI
2485,4,8,0,0,0,0,0,0,0.0,1905,1912,W Brearley ,ENG
2486,1,1,0,0,0,0,0,0,0.0,1993,1993,GA Briant ,ZIM
2487,2,4,0,0,0,0,0,0,0.0,2017,2017,NT Broom ,NZ
2488,2,3,0,0,0,0,0,0,0.0,1931,1932,LS Brown ,SA
2489,2,4,0,0,0,0,0,0,0.0,1993,1993,GK Bruk-Jackson ,ZIM
2490,1,1,0,0,0,0,0,0,0.0,1946,1946,C Burke ,NZ
2491,2,4,0,0,0,0,0,0,0.0,1962,1965,SF Burke ,SA
2492,2,4,0,0,0,0,0,0,0.0,1890,1890,EJK Burn ,AUS
2493,1,2,0,0,0,0,0,0,0.0,1979,1979,AR Butcher ,ENG
2494,1,1,0,0,0,0,0,0,0.0,1955,1955,LS Butler ,WI
2495,1,1,0,0,0,0,0,0,0.0,1946,1946,LA Butterfield ,NZ
2496,1,2,0,0,0,0,0,0,0.0,1922,1922,ID Buys ,SA
2497,3,6,0,0,0,0,0,0,0.0,1892,1895,ST Callaway ,AUS
2498,5,10,0,0,0,0,0,0,0.0,1948,1949,FJ Cameron ,WI
2499,2,4,0,0,0,0,0,0,0.0,1939,1939,JH Cameron ,WI
2500,2,2,0,0,0,0,0,0,0.0,1951,1952,DB Carr ,ENG
2501,1,2,0,0,0,0,0,0,0.0,1909,1909,DW Carr ,ENG
2502,2,4,0,0,0,0,0,0,0.0,2017,2017,HWR Cartwright ,AUS
2503,3,3,0,0,0,0,0,0,0.0,1928,1928,G Challenor ,WI
2504,1,2,0,0,0,0,0,0,0.0,1979,1979,HS Chang ,WI
2505,2,4,0,0,0,0,0,0,0.0,1890,1890,PC Charlton ,AUS
2506,2,4,0,0,0,0,0,0,0.0,1877,1877,HRJ Charlwood ,ENG
2507,9,17,0,0,0,0,0,0,0.0,2013,2018,TL Chatara ,ZIM
2508,1,2,0,0,0,0,0,0,0.0,1892,1892,W Chatterton ,ENG
2509,3,4,0,0,0,0,0,0,0.0,2016,2017,CJ Chibhabha ,ZIM
2510,2,3,0,0,0,0,0,0,0.0,2016,2016,MT Chinouya ,ZIM
2511,1,1,0,0,0,0,0,0,0.0,2017,2017,TS Chisoro ,ZIM
2512,1,1,0,0,0,0,0,0,0.0,2000,2000,N Chopra ,INDIA
2513,2,3,0,0,0,0,0,0,0.0,1949,1951,NR Chowdhury ,INDIA
2514,1,2,0,0,0,0,0,0,0.0,1884,1884,S Christopherson ,ENG
2515,5,9,0,0,0,0,0,0,0.0,1951,1951,GWA Chubb ,SA
2516,8,15,0,0,0,0,0,0,0.0,1929,1934,EW Clark ,ENG
2517,3,6,0,0,0,0,0,0,0.0,1939,1939,CB Clarke ,WI
2518,2,2,0,0,0,0,0,0,0.0,1932,1946,DC Cleverley ,NZ
2519,1,2,0,0,0,0,0,0,0.0,1931,1931,JAK Cochran ,SA
2520,1,2,0,0,0,0,0,0,0.0,1894,1895,A Coningham ,AUS
2521,1,2,0,0,0,0,0,0,0.0,1947,1947,C Cook ,ENG
2522,1,2,0,0,0,0,0,0,0.0,1896,1896,FJ Cook ,SA
2523,2,4,0,0,0,0,0,0,0.0,1997,1997,SH Cook ,AUS
2524,3,5,0,0,0,0,0,0,0.0,1992,1993,SJ Cook ,SA
2525,5,8,0,0,0,0,0,0,0.0,1964,1964,GE Corling ,AUS
2526,2,2,0,0,0,0,0,0,0.0,2013,2014,SS Cottrell ,WI
2527,1,2,0,0,0,0,0,0,0.0,1882,1882,G Coulthard ,AUS
2528,2,4,0,0,0,0,0,0,0.0,1889,1889,Hon.CJ Coventry ,ENG
2529,1,2,0,0,0,0,0,0,0.0,1948,1948,A Coxon ,ENG
2530,1,1,0,0,0,0,0,0,0.0,2018,2018,MS Crane ,ENG
2531,1,2,0,0,0,0,0,0,0.0,2019,2019,Z Crawley ,ENG
2532,3,4,0,0,0,0,0,0,0.0,1949,1951,GF Cresswell ,NZ
2533,1,1,0,0,0,0,0,0,0.0,1892,1892,G Cripps ,SA
2534,3,5,0,0,0,0,0,0,0.0,1992,1992,GJ Crocker ,ZIM
2535,1,2,0,0,0,0,0,0,0.0,2006,2006,DJ Cullen ,AUS
2536,2,3,0,0,0,0,0,0,0.0,2017,2018,TK Curran ,ENG
2537,2,4,0,0,0,0,0,0,0.0,1998,1999,AC Dale ,AUS
2538,5,6,0,0,0,0,0,0,0.0,1958,1958,JW D'Arcy ,NZ
2539,5,6,0,0,0,0,0,0,0.0,1936,1939,EQ Davies ,SA
2540,1,1,0,0,0,0,0,0,0.0,1986,1986,SP Davis ,AUS
2541,2,4,0,0,0,0,0,0,0.0,2003,2003,AC Dawson ,SA
2542,5,8,0,0,0,0,0,0,0.0,1928,1930,EW Dawson ,ENG
2543,3,5,0,0,0,0,0,0,0.0,2004,2004,Z de Bruyn ,SA
2544,5,7,0,0,0,0,0,0,0.0,1993,1994,RP de Groen ,NZ
2545,2,4,0,0,0,0,0,0,0.0,1971,1974,AR Dell ,AUS
2546,4,8,0,0,0,0,0,0,0.0,1982,1982,GRA de Silva ,SL
2547,9,16,0,0,0,0,0,0,0.0,1955,1958,DT Dewdney ,WI
2548,5,8,0,0,0,0,0,0,0.0,1948,1950,JG Dewes ,ENG
2549,1,2,0,0,0,0,0,0,0.0,1921,1921,AE Dipper ,ENG
2550,1,2,0,0,0,0,0,0,0.0,2019,2019,GH Dockrell ,IRE
2551,2,3,0,0,0,0,0,0,0.0,1950,1950,RG Draper ,SA
2552,1,2,0,0,0,0,0,0,0.0,1971,1971,JRF Duncan ,AUS
2553,1,2,0,0,0,0,0,0,0.0,1921,1921,FJ Durston ,ENG
2554,3,6,0,0,0,0,0,0,0.0,1947,1947,DV Dyer ,SA
2555,1,2,0,0,0,0,0,0,0.0,1971,1971,KH Eastwood ,AUS
2556,1,2,0,0,0,0,0,0,0.0,1934,1934,HI Ebeling ,AUS
2557,5,9,0,0,0,0,0,0,0.0,1968,1969,RM Edwards ,WI
2558,3,6,0,0,0,0,0,0,0.0,1974,1974,WJ Edwards ,AUS
2559,1,1,0,0,0,0,0,0,0.0,2002,2002,Ehsanul Haque ,BDESH
2560,3,5,0,0,0,0,0,0,0.0,2013,2015,Ehsan Adil ,PAK
2561,2,3,0,0,0,0,0,0,0.0,1952,1952,RWG Emery ,NZ
2562,1,2,0,0,0,0,0,0,0.0,1948,1948,GM Emmett ,ENG
2563,1,2,0,0,0,0,0,0,0.0,1921,1921,AJ Evans ,ENG
2564,4,7,0,0,0,0,0,0,0.0,2018,2019,Faheem Ashraf ,PAK
2565,1,2,0,0,0,0,0,0,0.0,2004,2004,Faisal Hossain ,BDESH
2566,1,2,0,0,0,0,0,0,0.0,2003,2003,Farhan Adil ,PAK
2567,1,2,0,0,0,0,0,0,0.0,1964,1964,Farooq Hamid ,PAK
2568,1,2,0,0,0,0,0,0,0.0,1976,1976,Farrukh Zaman ,PAK
2569,1,2,0,0,0,0,0,0,0.0,2013,2013,JP Faulkner ,AUS
2570,1,1,0,0,0,0,0,0,0.0,2016,2016,CJ Ferguson ,AUS
2571,1,2,0,0,0,0,0,0,0.0,2019,2019,LH Ferguson ,NZ
2572,2,3,0,0,0,0,0,0,0.0,1928,1930,MP Fernandes ,WI
2573,5,8,0,0,0,0,0,0,0.0,1983,1984,ERNS Fernando ,SL
2574,2,4,0,0,0,0,0,0,0.0,2003,2003,KADM Fernando ,SL
2575,1,1,0,0,0,0,0,0,0.0,2005,2005,NR Ferreira ,ZIM
2576,1,2,0,0,0,0,0,0,0.0,1889,1889,CE Finlason ,SA
2577,1,1,0,0,0,0,0,0,0.0,1953,1953,FE Fisher ,NZ
2578,4,7,0,0,0,0,0,0,0.0,1961,1964,JA Flavell ,ENG
2579,10,18,0,0,0,0,0,0,0.0,1935,1938,LO Fleetwood-Smith ,AUS
2580,1,2,0,0,0,0,0,0,0.0,1910,1910,CE Floquet ,SA
2581,1,2,0,0,0,0,0,0,0.0,1930,1930,H Foley ,NZ
2582,2,4,0,0,0,0,0,0,0.0,1889,1889,AJ Fothergill ,ENG
2583,3,6,0,0,0,0,0,0,0.0,1921,1921,CN Frank ,SA
2584,1,1,0,0,0,0,0,0,0.0,1896,1896,WHB Frank ,SA
2585,1,2,0,0,0,0,0,0,0.0,1954,1954,MC Frederick ,WI
2586,2,2,0,0,0,0,0,0,0.0,1933,1933,DL Freeman ,NZ
2587,1,2,0,0,0,0,0,0,0.0,1946,1946,FAW Freer ,AUS
2588,1,2,0,0,0,0,0,0,0.0,1935,1935,RL Fuller ,WI
2589,3,5,0,0,0,0,0,0,0.0,1955,1956,HA Furlonge ,WI
2590,1,1,0,0,0,0,0,0,0.0,1952,1952,HG Gaekwad ,INDIA
2591,1,2,0,0,0,0,0,0,0.0,1999,1999,IS Gallage ,SL
2592,1,2,0,0,0,0,0,0,0.0,1937,1937,N Gallichan ,NZ
2593,5,9,0,0,0,0,0,0,0.0,2017,2018,PLS Gamage ,SL
2594,4,7,0,0,0,0,0,0,0.0,1997,1997,D Ganesh ,INDIA
2595,1,2,0,0,0,0,0,0,0.0,1948,1948,AG Ganteaume ,WI
2596,4,8,0,0,0,0,0,0,0.0,1964,1965,SG Gedye ,NZ
2597,1,2,0,0,0,0,0,0,0.0,2010,2010,PR George ,AUS
2598,2,2,0,0,0,0,0,0,0.0,1954,1954,MEZ Ghazali ,PAK
2599,1,2,0,0,0,0,0,0,0.0,1967,1967,Ghulam Abbas ,PAK
2600,2,4,0,0,0,0,0,0,0.0,1995,1999,OD Gibson ,WI
2601,4,7,0,0,0,0,0,0,0.0,1999,2000,ESH Giddins ,ENG
2602,9,13,0,0,0,0,0,0,0.0,1985,1986,DR Gilbert ,AUS
2603,1,1,0,0,0,0,0,0,0.0,1986,1986,SR Gillespie ,NZ
2604,4,6,0,0,0,0,0,0,0.0,1930,1930,AHH Gilligan ,ENG
2605,1,2,0,0,0,0,0,0,0.0,1930,1930,G Gladstone ,WI
2606,1,1,0,0,0,0,0,0,0.0,1896,1896,GK Glover ,SA
2607,3,6,0,0,0,0,0,0,0.0,1877,1879,DW Gregory ,AUS
2608,2,4,0,0,0,0,0,0,0.0,1982,1982,IA Greig ,ENG
2609,2,4,0,0,0,0,0,0,0.0,1889,1889,BAF Grieve ,ENG
2610,2,3,0,0,0,0,0,0,0.0,1960,1960,GM Griffin ,SA
2611,1,2,0,0,0,0,0,0,0.0,1880,1880,TU Groube ,AUS
2612,1,2,0,0,0,0,0,0,0.0,1963,1963,CEJ Guest ,AUS
2613,1,1,0,0,0,0,0,0,0.0,1983,1983,RPW Guneratne ,SL
2614,3,5,0,0,0,0,0,0,0.0,1961,1965,BP Gupte ,INDIA
2615,2,4,0,0,0,0,0,0,0.0,1999,1999,A Habib ,ENG
2616,1,2,0,0,0,0,0,0,0.0,1965,1965,GG Hall ,SA
2617,2,3,0,0,0,0,0,0,0.0,1921,1928,C Hallows ,ENG
2618,1,1,0,0,0,0,0,0,0.0,1999,1999,GM Hamilton ,ENG
2619,1,2,0,0,0,0,0,0,0.0,1914,1914,RHM Hands ,SA
2620,1,2,0,0,0,0,0,0,0.0,1949,1949,MA Hanley ,SA
2621,1,2,0,0,0,0,0,0,0.0,1921,1921,HTW Hardinge ,ENG
2622,8,11,0,0,0,0,0,0,0.0,1955,1958,NS Harford ,NZ
2623,2,2,0,0,0,0,0,0,0.0,1959,1959,RM Harris ,NZ
2624,5,6,0,0,0,0,0,0,0.0,1912,1914,GPD Hartigan ,SA
2625,1,2,0,0,0,0,0,0,0.0,1925,1925,AEV Hartkopf ,AUS
2626,1,2,0,0,0,0,0,0,0.0,1947,1947,MR Harvey ,AUS
2627,2,2,0,0,0,0,0,0,0.0,1936,1936,RL Harvey ,SA
2628,3,6,0,0,0,0,0,0,0.0,1998,2001,Harvinder Singh ,INDIA
2629,1,2,0,0,0,0,0,0,0.0,1892,1892,GG Hearne ,ENG
2630,1,2,0,0,0,0,0,0,0.0,2001,2001,D Hettiarachchi ,SL
2631,1,2,0,0,0,0,0,0,0.0,1896,1896,CFW Hime ,SA
2632,2,4,0,0,0,0,0,0,0.0,1877,1877,JR Hodges ,AUS
2633,2,3,0,0,0,0,0,0,0.0,1934,1934,JL Hopwood ,ENG
2634,3,5,0,0,0,0,0,0,0.0,1879,1884,AN Hornby ,ENG
2635,1,1,0,0,0,0,0,0,0.0,1972,1972,AB Howard ,WI
2636,5,8,0,0,0,0,0,0,0.0,1920,1924,H Howell ,ENG
2637,1,1,0,0,0,0,0,0,0.0,2001,2001,Humayun Farhat ,PAK
2638,4,6,0,0,0,0,0,0,0.0,1948,1949,KC Ibrahim ,INDIA
2639,5,9,0,0,0,0,0,0,0.0,1935,1935,J Iddon ,ENG
2640,1,2,0,0,0,0,0,0,0.0,2006,2006,Iftikhar Anjum ,PAK
2641,5,8,0,0,0,0,0,0,0.0,1980,1988,Ijaz Faqih ,PAK
2642,5,8,0,0,0,0,0,0,0.0,1993,1995,MC Ilott ,ENG
2643,10,19,0,0,0,0,0,0,0.0,2014,2019,Imran Khan ,PAK
2644,2,4,0,0,0,0,0,0,0.0,2010,2010,PJ Ingram ,NZ
2645,4,7,0,0,0,0,0,0,0.0,1981,1982,RD Jackman ,ENG
2646,1,2,0,0,0,0,0,0,0.0,2008,2008,AS Jaggernauth ,WI
2647,1,2,0,0,0,0,0,0,0.0,1933,1933,LP Jai ,INDIA
2648,6,9,0,0,0,0,0,0,0.0,1982,1985,Jalal-ud-Din ,PAK
2649,2,4,0,0,0,0,0,0,0.0,1998,1998,SP James ,ENG
2650,4,6,0,0,0,0,0,0,0.0,1971,1974,JA Jameson ,ENG
2651,2,3,0,0,0,0,0,0,0.0,2018,2019,Javed Ahmadi ,AFG
2652,1,1,0,0,0,0,0,0,0.0,1962,1962,Javed Akhtar ,PAK
2653,1,2,0,0,0,0,0,0,0.0,1971,1971,HK Jayantilal ,INDIA
2654,1,1,0,0,0,0,0,0,0.0,1982,1982,RSA Jayasekera ,SL
2655,2,3,0,0,0,0,0,0,0.0,1983,1983,S Jeganathan ,SL
2656,2,4,0,0,0,0,0,0,0.0,1996,1996,DJ Johnson ,INDIA
2657,3,6,0,0,0,0,0,0,0.0,1948,1950,HHH Johnson ,WI
2658,3,6,0,0,0,0,0,0,0.0,2003,2003,RL Johnson ,ENG
2659,1,2,0,0,0,0,0,0,0.0,2003,2003,RA Jones ,NZ
2660,1,2,0,0,0,0,0,0,0.0,1968,1968,LR Joslin ,AUS
2661,7,13,0,0,0,0,0,0,0.0,2016,2018,Kamrul Islam Rabbi ,BDESH
2662,1,2,0,0,0,0,0,0,0.0,2014,2014,TP Kamungozi ,ZIM
2663,1,2,0,0,0,0,0,0,0.0,2018,2018,TE Kane ,IRE
2664,2,3,0,0,0,0,0,0,0.0,1999,2000,HH Kanitkar ,INDIA
2665,2,3,0,0,0,0,0,0,0.0,1974,1974,HS Kanitkar ,INDIA
2666,2,2,0,0,0,0,0,0,0.0,1934,1939,WW Keeton ,ENG
2667,1,2,0,0,0,0,0,0,0.0,1889,1889,GA Kempis ,SA
2668,1,2,0,0,0,0,0,0,0.0,2013,2013,SC Kerrigan ,ENG
2669,1,1,0,0,0,0,0,0,0.0,1954,1954,Khalid Hasan ,PAK
2670,2,2,0,0,0,0,0,0,0.0,1954,1954,Khalid Wazir ,PAK
2671,1,2,0,0,0,0,0,0,0.0,2009,2009,A Khan ,ENG
2672,1,2,0,0,0,0,0,0,0.0,1909,1909,JH King ,ENG
2673,1,2,0,0,0,0,0,0,0.0,1911,1911,SP Kinneir ,ENG
2674,2,4,0,0,0,0,0,0,0.0,1907,1907,NA Knox ,ENG
2675,1,2,0,0,0,0,0,0,0.0,2011,2011,CKB Kulasekara ,SL
2676,4,8,0,0,0,0,0,0,0.0,1967,1968,UN Kulkarni ,INDIA
2677,2,3,0,0,0,0,0,0,0.0,1986,1987,AK Kuruppuarachchi ,SL
2678,10,15,0,0,0,0,0,0,0.0,1997,1997,A Kuruvilla ,INDIA
2679,1,2,0,0,0,0,0,0,0.0,1899,1899,F Kuys ,SA
2680,2,3,0,0,0,0,0,0,0.0,1993,1993,MN Lathwell ,ENG
2681,5,10,0,0,0,0,0,0,0.0,1988,1992,DV Lawrence ,ENG
2682,1,2,0,0,0,0,0,0,0.0,1931,1931,HW Lee ,ENG
2683,9,10,0,0,0,0,0,0,0.0,1952,1956,JG Leggat ,NZ
2684,1,2,0,0,0,0,0,0,0.0,1914,1914,FL le Roux ,SA
2685,9,17,0,0,0,0,0,0,0.0,1972,1973,AR Lewis ,ENG
2686,1,2,0,0,0,0,0,0,0.0,2006,2006,J Lewis ,ENG
2687,1,1,0,0,0,0,0,0,0.0,1913,1913,PT Lewis ,SA
2688,5,9,0,0,0,0,0,0,0.0,1997,2008,RN Lewis ,WI
2689,1,1,0,0,0,0,0,0,0.0,2019,2019,GF Linde ,SA
2690,9,15,0,0,0,0,0,0,0.0,1992,2001,DK Liyanage ,SL
2691,1,1,0,0,0,0,0,0,0.0,1984,1984,TA Lloyd ,ENG
2692,1,2,0,0,0,0,0,0,0.0,1995,1995,ACI Lock ,ZIM
2693,1,2,0,0,0,0,0,0,0.0,1996,1996,GR Loveridge ,NZ
2694,1,2,0,0,0,0,0,0,0.0,1914,1914,EB Lundie ,SA
2695,1,2,0,0,0,0,0,0,0.0,1965,1965,MJ Macaulay ,SA
2696,2,4,0,0,0,0,0,0,0.0,2019,2019,AR McBrine ,IRE
2697,1,1,0,0,0,0,0,0,0.0,1924,1924,JCW MacBryan ,ENG
2698,1,1,0,0,0,0,0,0,0.0,2009,2009,BE McGain ,AUS
2699,2,3,0,0,0,0,0,0,0.0,1930,1930,HM McGirr ,NZ
2700,2,4,0,0,0,0,0,0,0.0,1995,1996,PE McIntyre ,AUS
2701,1,1,0,0,0,0,0,0,0.0,2010,2010,AJ McKay ,NZ
2702,1,2,0,0,0,0,0,0,0.0,1879,1879,FA MacKinnon ,ENG
2703,1,2,0,0,0,0,0,0,0.0,1912,1912,JW McLaren ,AUS
2704,2,4,0,0,0,0,0,0,0.0,2010,2014,R McLaren ,SA
2705,1,2,0,0,0,0,0,0,0.0,1930,1930,EG McLeod ,NZ
2706,1,2,0,0,0,0,0,0,0.0,1889,1889,JEP McMaster ,ENG
2707,1,1,0,0,0,0,0,0,0.0,1946,1946,DAN McRae ,NZ
2708,3,5,0,0,0,0,0,0,0.0,1988,1992,MAWR Madurasinghe ,SL
2709,4,6,0,0,0,0,0,0,0.0,2008,2008,Mahbubul Alam ,BDESH
2710,8,14,0,0,0,0,0,0,0.0,2006,2007,SI Mahmood ,ENG
2711,4,7,0,0,0,0,0,0,0.0,1920,1921,JWH Makepeace ,ENG
2712,2,4,0,0,0,0,0,0,0.0,1992,1992,NA Mallender ,ENG
2713,1,2,0,0,0,0,0,0,0.0,1977,1977,MF Malone ,AUS
2714,1,2,0,0,0,0,0,0,0.0,1949,1949,LA Markham ,SA
2715,6,12,0,0,0,0,0,0,0.0,1982,1984,VJ Marks ,ENG
2716,1,2,0,0,0,0,0,0,0.0,1885,1885,AP Marr ,AUS
2717,1,2,0,0,0,0,0,0,0.0,1955,1955,NE Marshall ,WI
2718,5,9,0,0,0,0,0,0,0.0,2013,2013,BP Martin ,NZ
2719,1,2,0,0,0,0,0,0,0.0,1947,1947,JW Martin ,ENG
2720,3,6,0,0,0,0,0,0,0.0,1921,1921,WFE Marx ,SA
2721,1,2,0,0,0,0,0,0,0.0,2004,2004,MJ Mason ,NZ
2722,1,2,0,0,0,0,0,0,0.0,1990,1990,Masood Anwar ,PAK
2723,2,3,0,0,0,0,0,0,0.0,2016,2016,PS Masvaure ,ZIM
2724,3,6,0,0,0,0,0,0,0.0,1996,1999,EZ Matambanadzo ,ZIM
2725,2,3,0,0,0,0,0,0,0.0,1958,1958,T Meale ,NZ
2726,1,1,0,0,0,0,0,0,0.0,2016,2016,JM Mennie ,AUS
2727,2,4,0,0,0,0,0,0,0.0,2013,2013,KO Meth ,ZIM
2728,1,1,0,0,0,0,0,0,0.0,1953,1953,EM Meuli ,NZ
2729,1,2,0,0,0,0,0,0,0.0,1896,1896,AM Miller ,ENG
2730,1,2,0,0,0,0,0,0,0.0,2009,2009,NO Miller ,WI
2731,1,2,0,0,0,0,0,0,0.0,1953,1953,RC Miller ,WI
2732,9,16,0,0,0,0,0,0,0.0,1911,1912,RB Minnett ,AUS
2733,2,4,0,0,0,0,0,0,0.0,1955,1955,Miran Bakhsh ,PAK
2734,2,3,0,0,0,0,0,0,0.0,2017,2017,SF Mire ,ZIM
2735,1,2,0,0,0,0,0,0,0.0,2018,2018,Mir Hamza ,PAK
2736,1,1,0,0,0,0,0,0,0.0,2019,2019,DJ Mitchell ,NZ
2737,1,2,0,0,0,0,0,0,0.0,1935,1935,NS Mitchell-Innes ,ENG
2738,4,8,0,0,0,0,0,0,0.0,2010,2011,A Mithun ,INDIA
2739,1,1,0,0,0,0,0,0,0.0,1954,1954,Mohammad Aslam ,PAK
2740,4,6,0,0,0,0,0,0,0.0,2013,2013,Mohammad Irfan ,PAK
2741,2,4,0,0,0,0,0,0,0.0,2004,2005,Mohammad Khalil ,PAK
2742,4,8,0,0,0,0,0,0,0.0,1959,1962,Mohammad Munaf ,PAK
2743,5,6,0,0,0,0,0,0,0.0,2015,2015,Mohammad Shahid ,BDESH
2744,2,3,0,0,0,0,0,0,0.0,2018,2019,Mohammad Shahzad ,AFG
2745,5,9,0,0,0,0,0,0,0.0,1996,2003,Mohammad Zahid ,PAK
2746,2,4,0,0,0,0,0,0,0.0,1997,1997,DS Mohanty ,INDIA
2747,1,2,0,0,0,0,0,0,0.0,2009,2009,JA Morkel ,SA
2748,7,13,0,0,0,0,0,0,0.0,1949,1952,J Moroney ,AUS
2749,1,2,0,0,0,0,0,0,0.0,1885,1885,S Morris ,AUS
2750,1,2,0,0,0,0,0,0,0.0,1979,1979,JK Moss ,AUS
2751,2,3,0,0,0,0,0,0,0.0,1959,1960,VM Muddiah ,INDIA
2752,1,2,0,0,0,0,0,0,0.0,1935,1935,GH Mudie ,WI
2753,1,1,0,0,0,0,0,0,0.0,2019,2019,Muhammad Musa ,PAK
2754,1,1,0,0,0,0,0,0,0.0,2018,2018,Mujeeb Ur Rahman ,AFG
2755,1,2,0,0,0,0,0,0,0.0,2019,2019,PWA Mulder ,SA
2756,1,1,0,0,0,0,0,0,0.0,2013,2013,C Munro ,NZ
2757,2,4,0,0,0,0,0,0,0.0,1992,1992,TA Munton ,ENG
2758,1,1,0,0,0,0,0,0,0.0,2004,2004,T Mupariwa ,ZIM
2759,3,6,0,0,0,0,0,0,0.0,2018,2019,TJ Murtagh ,IRE
2760,1,2,0,0,0,0,0,0,0.0,2017,2017,TK Musakanda ,ZIM
2761,1,2,0,0,0,0,0,0,0.0,1885,1885,HA Musgrove ,AUS
2762,1,2,0,0,0,0,0,0,0.0,2000,2000,DT Mutendera ,ZIM
2763,1,1,0,0,0,0,0,0,0.0,2012,2012,F Mutizwa ,ZIM
2764,1,1,0,0,0,0,0,0,0.0,2017,2017,B Muzarabani ,ZIM
2765,1,2,0,0,0,0,0,0,0.0,2005,2005,W Mwayenga ,ZIM
2766,1,1,0,0,0,0,0,0,0.0,1990,1990,Nadeem Ghauri ,PAK
2767,2,4,0,0,0,0,0,0,0.0,1993,1999,Nadeem Khan ,PAK
2768,1,2,0,0,0,0,0,0,0.0,1932,1932,LE Nagel ,AUS
2769,3,4,0,0,0,0,0,0,0.0,1974,1975,SS Naik ,INDIA
2770,3,6,0,0,0,0,0,0,0.0,1932,1934,Naoomal Jaoomal ,INDIA
2771,3,4,0,0,0,0,0,0,0.0,2019,2019,Naseem Shah ,PAK
2772,1,2,0,0,0,0,0,0,0.0,2019,2019,Nasir Jamal ,AFG
2773,2,4,0,0,0,0,0,0,0.0,1989,1990,Naved Anjum ,PAK
2774,2,4,0,0,0,0,0,0,0.0,1998,2000,Naved Ashraf ,PAK
2775,1,2,0,0,0,0,0,0,0.0,2002,2002,Naved Latif ,PAK
2776,1,2,0,0,0,0,0,0,0.0,2002,2002,MN Nawaz ,SL
2777,2,4,0,0,0,0,0,0,0.0,1932,1934,S Nazir Ali ,INDIA
2778,2,3,0,0,0,0,0,0,0.0,2004,2011,Nazmul Hossain ,BDESH
2779,1,2,0,0,0,0,0,0,0.0,2018,2018,Nazmul Islam ,BDESH
2780,1,2,0,0,0,0,0,0,0.0,1935,1935,JM Neblett ,WI
2781,1,2,0,0,0,0,0,0,0.0,1888,1888,W Newham ,ENG
2782,3,3,0,0,0,0,0,0,0.0,1932,1933,J Newman ,NZ
2783,1,2,0,0,0,0,0,0,0.0,1998,1998,MJ Nicholson ,AUS
2784,3,6,0,0,0,0,0,0,0.0,1928,1928,JFW Nicolson ,SA
2785,4,7,0,0,0,0,0,0,0.0,2003,2003,RAP Nissanka ,SL
2786,3,4,0,0,0,0,0,0,0.0,2019,2019,A Nortje ,SA
2787,1,2,0,0,0,0,0,0,0.0,1910,1910,NO Norton ,SA
2788,1,2,0,0,0,0,0,0,0.0,1928,1928,OE Nothling ,AUS
2789,1,1,0,0,0,0,0,0,0.0,1952,1952,S Nyalchand ,INDIA
2790,3,6,0,0,0,0,0,0,0.0,2018,2019,KJ O'Brien ,IRE
2791,2,3,0,0,0,0,0,0,0.0,1889,1889,AE Ochse ,SA
2792,9,16,0,0,0,0,0,0,0.0,2014,2017,SNJ O'Keefe ,AUS
2793,1,1,0,0,0,0,0,0,0.0,1939,1939,N Oldfield ,ENG
2794,3,5,0,0,0,0,0,0,0.0,1992,1996,AH Omarshah ,ZIM
2795,9,16,0,0,0,0,0,0,0.0,2009,2012,G Onions ,ENG
2796,2,3,0,0,0,0,0,0,0.0,2001,2001,J Ormond ,ENG
2797,2,4,0,0,0,0,0,0,0.0,1960,1960,DEV Padgett ,ENG
2798,2,4,0,0,0,0,0,0,0.0,1976,1976,AL Padmore ,WI
2799,2,4,0,0,0,0,0,0,0.0,2005,2005,DJ Pagon ,WI
2800,1,2,0,0,0,0,0,0,0.0,1969,1969,AM Pai ,INDIA
2801,2,4,0,0,0,0,0,0,0.0,1932,1936,PE Palia ,INDIA
2802,1,2,0,0,0,0,0,0,0.0,1954,1954,CH Palmer ,ENG
2803,1,2,0,0,0,0,0,0,0.0,1965,1965,KE Palmer ,ENG
2804,1,2,0,0,0,0,0,0,0.0,1920,1921,RL Park ,AUS
2805,2,4,0,0,0,0,0,0,0.0,1972,1973,RD Parkar ,INDIA
2806,1,1,0,0,0,0,0,0,0.0,1921,1921,CWL Parker ,ENG
2807,2,2,0,0,0,0,0,0,0.0,1924,1924,GM Parker ,SA
2808,1,2,0,0,0,0,0,0,0.0,1981,1981,PWG Parker ,ENG
2809,1,2,0,0,0,0,0,0,0.0,1937,1937,JH Parks ,ENG
2810,2,4,0,0,0,0,0,0,0.0,1979,1979,DD Parsana ,INDIA
2811,6,11,0,0,0,0,0,0,0.0,1932,1946,Nawab of Pataudi snr ,ENG
2812,1,2,0,0,0,0,0,0,0.0,2008,2008,DJ Pattinson ,ENG
2813,1,2,0,0,0,0,0,0,0.0,1880,1880,F Penn ,ENG
2814,1,1,0,0,0,0,0,0,0.0,2014,2014,KK Peters ,WI
2815,1,2,0,0,0,0,0,0,0.0,1992,1992,WN Phillips ,AUS
2816,1,2,0,0,0,0,0,0,0.0,1948,1948,LR Pierre ,WI
2817,1,1,0,0,0,0,0,0,0.0,1984,1984,ACS Pigott ,ENG
2818,3,6,0,0,0,0,0,0,0.0,1948,1948,W Place ,ENG
2819,1,2,0,0,0,0,0,0,0.0,1947,1947,JB Plimsoll ,SA
2820,1,2,0,0,0,0,0,0,0.0,1947,1947,GH Pope ,ENG
2821,1,2,0,0,0,0,0,0,0.0,1885,1885,RJ Pope ,AUS
2822,2,4,0,0,0,0,0,0,0.0,2007,2007,RR Powar ,INDIA
2823,1,1,0,0,0,0,0,0,0.0,2011,2011,S Prasanna ,SL
2824,4,8,0,0,0,0,0,0,0.0,2002,2003,D Pretorius ,SA
2825,3,6,0,0,0,0,0,0,0.0,1968,1969,RM Prideaux ,ENG
2826,3,5,0,0,0,0,0,0,0.0,1990,1998,MW Priest ,NZ
2827,1,2,0,0,0,0,0,0,0.0,1899,1899,CFH Prince ,SA
2828,4,7,0,0,0,0,0,0,0.0,1992,1995,MW Pringle ,SA
2829,1,2,0,0,0,0,0,0,0.0,2000,2000,Qaiser Abbas ,PAK
2830,1,2,0,0,0,0,0,0,0.0,2019,2019,Qais Ahmad ,AFG
2831,3,6,0,0,0,0,0,0,0.0,1986,1988,NV Radford ,ENG
2832,1,1,0,0,0,0,0,0,0.0,2002,2002,Rafiqul Islam ,BDESH
2833,2,4,0,0,0,0,0,0,0.0,1999,1999,S Ragoonath ,WI
2834,1,2,0,0,0,0,0,0,0.0,1948,1948,K Rai Singh ,INDIA
2835,1,2,0,0,0,0,0,0,0.0,1964,1964,Rajinder Pal ,INDIA
2836,2,3,0,0,0,0,0,0,0.0,1936,1936,C Ramaswami ,INDIA
2837,2,4,0,0,0,0,0,0,0.0,1982,1982,AN Ranasinghe ,SL
2838,2,4,0,0,0,0,0,0,0.0,1989,1989,D Ranatunga ,SL
2839,1,1,0,0,0,0,0,0,0.0,1993,1993,U Ranchod ,ZIM
2840,4,4,0,0,0,0,0,0,0.0,1948,1948,CR Rangachari ,INDIA
2841,3,6,0,0,0,0,0,0,0.0,2014,2019,WB Rankin ,ENG
2842,4,7,0,0,0,0,0,0,0.0,2018,2019,Rashid Khan ,AFG
2843,2,2,0,0,0,0,0,0,0.0,1989,1989,V Razdan ,INDIA
2844,1,2,0,0,0,0,0,0,0.0,1935,1935,HD Read ,ENG
2845,1,2,0,0,0,0,0,0,0.0,1973,1973,RE Redmond ,NZ
2846,1,2,0,0,0,0,0,0,0.0,1921,1921,N Reid ,SA
2847,1,2,0,0,0,0,0,0,0.0,2017,2017,RA Reifer ,WI
2848,2,4,0,0,0,0,0,0,0.0,1959,1959,HJ Rhodes ,ENG
2849,1,2,0,0,0,0,0,0,0.0,2004,2004,Riaz Afridi ,PAK
2850,1,1,0,0,0,0,0,0,0.0,1896,1896,AR Richards ,SA
2851,1,1,0,0,0,0,0,0,0.0,1889,1889,WHM Richards ,SA
2852,2,4,0,0,0,0,0,0,0.0,2019,2019,JA Richardson ,AUS
2853,1,2,0,0,0,0,0,0,0.0,1921,1921,TL Richmond ,ENG
2854,2,4,0,0,0,0,0,0,0.0,1948,1952,KR Rickards ,WI
2855,1,2,0,0,0,0,0,0,0.0,1956,1956,AT Roberts ,WI
2856,1,2,0,0,0,0,0,0,0.0,1999,1999,LA Roberts ,WI
2857,1,2,0,0,0,0,0,0,0.0,1986,1986,GK Robertson ,NZ
2858,1,2,0,0,0,0,0,0,0.0,1885,1885,WR Robertson ,AUS
2859,4,8,0,0,0,0,0,0,0.0,2017,2017,TS Roland-Jones ,ENG
2860,4,8,0,0,0,0,0,0,0.0,1969,1969,AK Roy ,INDIA
2861,5,10,0,0,0,0,0,0,0.0,1964,1965,FE Rumsey ,ENG
2862,1,2,0,0,0,0,0,0,0.0,1992,1992,MW Rushmere ,SA
2863,1,2,0,0,0,0,0,0,0.0,1956,1956,JW Rutherford ,AUS
2864,3,5,0,0,0,0,0,0,0.0,2008,2013,Sajedul Islam ,BDESH
2865,1,2,0,0,0,0,0,0,0.0,2001,2001,RL Sanghvi ,INDIA
2866,9,13,0,0,0,0,0,0,0.0,1946,1951,CT Sarwate ,INDIA
2867,1,2,0,0,0,0,0,0,0.0,1967,1967,RC Saxena ,INDIA
2868,2,4,0,0,0,0,0,0,0.0,2000,2000,CP Schofield ,ENG
2869,1,2,0,0,0,0,0,0,0.0,1879,1879,SS Schultz ,ENG
2870,1,2,0,0,0,0,0,0,0.0,1953,1953,AHP Scott ,WI
2871,8,11,0,0,0,0,0,0,0.0,1928,1931,OC Scott ,WI
2872,1,1,0,0,0,0,0,0,0.0,1947,1947,RH Scott ,NZ
2873,1,1,0,0,0,0,0,0,0.0,1933,1933,BJ Sealey ,WI
2874,2,2,0,0,0,0,0,0,0.0,1983,1983,TAP Sekhar ,INDIA
2875,1,2,0,0,0,0,0,0,0.0,1959,1959,AK Sengupta ,INDIA
2876,1,2,0,0,0,0,0,0,0.0,1997,1997,DG Sewell ,NZ
2877,6,10,0,0,0,0,0,0,0.0,1974,1981,Shafiq Ahmed ,PAK
2878,7,11,0,0,0,0,0,0,0.0,2018,2019,Shaheen Shah Afridi ,PAK
2879,1,1,0,0,0,0,0,0,0.0,1989,1989,Shahid Mahboob ,PAK
2880,1,1,0,0,0,0,0,0,0.0,1962,1962,Shahid Mahmood ,PAK
2881,1,2,0,0,0,0,0,0,0.0,1989,1989,Shahid Saeed ,PAK
2882,2,4,0,0,0,0,0,0,0.0,2016,2018,T Shamsi ,SA
2883,1,2,0,0,0,0,0,0,0.0,2017,2017,Sharjeel Khan ,PAK
2884,1,2,0,0,0,0,0,0,0.0,2014,2014,KV Sharma ,INDIA
2885,7,13,0,0,0,0,0,0,0.0,1946,1952,SG Shinde ,INDIA
2886,1,2,0,0,0,0,0,0,0.0,1982,1982,RC Shukla ,INDIA
2887,1,2,0,0,0,0,0,0,0.0,1888,1888,J Shuter ,ENG
2888,1,1,0,0,0,0,0,0,0.0,1985,1985,A Sidebottom ,ENG
2889,1,2,0,0,0,0,0,0,0.0,1938,1938,RA Sinfield ,ENG
2890,1,2,0,0,0,0,0,0,0.0,1959,1959,KN Slater ,AUS
2891,1,2,0,0,0,0,0,0,0.0,1880,1880,J Slight ,AUS
2892,1,2,0,0,0,0,0,0,0.0,1946,1946,TF Smailes ,ENG
2893,2,4,0,0,0,0,0,0,0.0,1984,1984,MA Small ,WI
2894,1,1,0,0,0,0,0,0,0.0,1997,1997,AM Smith ,ENG
2895,1,2,0,0,0,0,0,0,0.0,1889,1889,CA Smith ,ENG
2896,2,3,0,0,0,0,0,0,0.0,1912,1912,DBM Smith ,AUS
2897,2,4,0,0,0,0,0,0,0.0,1986,1986,DM Smith ,ENG
2898,3,6,0,0,0,0,0,0,0.0,1957,1957,DV Smith ,ENG
2899,1,1,0,0,0,0,0,0,0.0,1933,1933,HD Smith ,NZ
2900,2,4,0,0,0,0,0,0,0.0,1948,1948,GA Smithson ,ENG
2901,1,1,0,0,0,0,0,0,0.0,1947,1947,CA Snedden ,NZ
2902,1,2,0,0,0,0,0,0,0.0,2011,2011,Sohrawordi Shuvo ,BDESH
2903,3,6,0,0,0,0,0,0,0.0,2018,2019,WER Somerville ,NZ
2904,1,1,0,0,0,0,0,0,0.0,1960,1960,MM Sood ,INDIA
2905,1,2,0,0,0,0,0,0,0.0,1981,1981,TE Srinivasan ,INDIA
2906,3,6,0,0,0,0,0,0,0.0,1928,1928,SJ Staples ,ENG
2907,4,8,0,0,0,0,0,0,0.0,1962,1962,SC Stayers ,WI
2908,1,2,0,0,0,0,0,0,0.0,1989,1989,JP Stephenson ,ENG
2909,2,3,0,0,0,0,0,0,0.0,1980,1981,GB Stevenson ,ENG
2910,3,6,0,0,0,0,0,0,0.0,1995,1995,PJR Steyn ,SA
2911,2,4,0,0,0,0,0,0,0.0,1930,1930,EL St Hill ,WI
2912,1,2,0,0,0,0,0,0,0.0,1939,1939,VH Stollmeyer ,WI
2913,1,2,0,0,0,0,0,0,0.0,2019,2019,OP Stone ,ENG
2914,4,7,0,0,0,0,0,0,0.0,2017,2017,Subashis Roy ,BDESH
2915,2,4,0,0,0,0,0,0,0.0,1888,1888,FH Sugg ,ENG
2916,2,4,0,0,0,0,0,0,0.0,1955,1956,GR Sunderam ,INDIA
2917,1,1,0,0,0,0,0,0,0.0,2018,2018,Sunzamul Islam ,BDESH
2918,1,2,0,0,0,0,0,0,0.0,1955,1955,VN Swamy ,INDIA
2919,6,8,0,0,0,0,0,0,0.0,2005,2007,Syed Rasel ,BDESH
2920,1,2,0,0,0,0,0,0,0.0,1902,1902,HM Taberer ,SA
2921,1,2,0,0,0,0,0,0,0.0,1899,1899,VM Tancred ,SA
2922,2,4,0,0,0,0,0,0,0.0,1923,1923,LE Tapscott ,SA
2923,1,1,0,0,0,0,0,0,0.0,1948,1948,KK Tarapore ,INDIA
2924,1,2,0,0,0,0,0,0,0.0,1956,1956,AI Taylor ,SA
2925,2,4,0,0,0,0,0,0,0.0,1914,1914,D Taylor ,SA
2926,3,5,0,0,0,0,0,0,0.0,1958,1959,JO Taylor ,WI
2927,2,4,0,0,0,0,0,0,0.0,1993,1994,JP Taylor ,ENG
2928,1,2,0,0,0,0,0,0,0.0,2018,2018,SN Thakur ,INDIA
2929,1,1,0,0,0,0,0,0,0.0,1889,1889,NHCD Theunissen ,SA
2930,5,9,0,0,0,0,0,0,0.0,1986,1986,JG Thomas ,ENG
2931,2,3,0,0,0,0,0,0,0.0,1996,1997,PIC Thompson ,WI
2932,3,6,0,0,0,0,0,0,0.0,2018,2019,SR Thompson ,IRE
2933,1,2,0,0,0,0,0,0,0.0,1952,1952,GR Thoms ,AUS
2934,4,8,0,0,0,0,0,0,0.0,1970,1971,AL Thomson ,AUS
2935,2,4,0,0,0,0,0,0,0.0,1968,1968,K Thomson ,NZ
2936,1,2,0,0,0,0,0,0,0.0,1932,1932,HM Thurlow ,AUS
2937,1,1,0,0,0,0,0,0,0.0,1935,1935,DS Tomlinson ,SA
2938,1,2,0,0,0,0,0,0,0.0,2009,2009,GC Tonge ,WI
2939,2,4,0,0,0,0,0,0,0.0,1899,1899,CL Townsend ,ENG
2940,3,6,0,0,0,0,0,0,0.0,1948,1948,MF Tremlett ,ENG
2941,3,6,0,0,0,0,0,0,0.0,1946,1947,GE Tribe ,AUS
2942,1,2,0,0,0,0,0,0,0.0,1902,1902,PS Twentyman-Jones ,SA
2943,1,2,0,0,0,0,0,0,0.0,1896,1896,EJ Tyler ,ENG
2944,1,1,0,0,0,0,0,0,0.0,2010,2010,JD Unadkat ,INDIA
2945,2,4,0,0,0,0,0,0,0.0,1999,2002,KEA Upashantha ,SL
2946,1,1,0,0,0,0,0,0,0.0,2018,2018,Usman Salahuddin ,PAK
2947,1,1,0,0,0,0,0,0,0.0,2019,2019,Usman Shinwari ,PAK
2948,2,2,0,0,0,0,0,0,0.0,1933,1933,VA Valentine ,WI
2949,4,4,0,0,0,0,0,0,0.0,1988,1989,RH Vance ,NZ
2950,3,4,0,0,0,0,0,0,0.0,1964,1965,GD Varnals ,SA
2951,1,2,0,0,0,0,0,0,0.0,1882,1883,GF Vernon ,ENG
2952,1,2,0,0,0,0,0,0,0.0,2016,2016,GC Viljoen ,SA
2953,1,1,0,0,0,0,0,0,0.0,2012,2012,R Vinay Kumar ,INDIA
2954,2,4,0,0,0,0,0,0,0.0,1912,1912,J Vine ,ENG
2955,2,3,0,0,0,0,0,0,0.0,2018,2019,Wafadar Momand ,AFG
2956,1,2,0,0,0,0,0,0,0.0,1930,1930,LA Walcott ,WI
2957,5,8,0,0,0,0,0,0,0.0,2000,2002,BGK Walker ,NZ
2958,3,6,0,0,0,0,0,0,0.0,1995,2000,KP Walmsley ,NZ
2959,1,2,0,0,0,0,0,0,0.0,2019,2019,Waqar Salamkheil ,AFG
2960,10,15,0,0,0,0,0,0,0.0,1986,1994,KPJ Warnaweera ,SL
2961,2,3,0,0,0,0,0,0,0.0,1951,1951,JJ Warr ,ENG
2962,6,11,0,0,0,0,0,0,0.0,2001,2002,BT Watambwa ,ZIM
2963,1,2,0,0,0,0,0,0,0.0,1955,1955,L Watt ,NZ
2964,3,6,0,0,0,0,0,0,0.0,1971,1974,MG Webb ,NZ
2965,2,4,0,0,0,0,0,0,0.0,1939,1939,KH Weekes ,WI
2966,1,2,0,0,0,0,0,0,0.0,1985,1985,CDUS Weerasinghe ,SL
2967,1,1,0,0,0,0,0,0,0.0,1995,1995,AP Wells ,ENG
2968,5,8,0,0,0,0,0,0,0.0,1954,1958,RJ Westcott ,SA
2969,1,2,0,0,0,0,0,0,0.0,1949,1949,A Wharton ,ENG
2970,2,3,0,0,0,0,0,0,0.0,1990,1990,DJ White ,NZ
2971,2,4,0,0,0,0,0,0,0.0,1961,1962,DW White ,ENG
2972,2,2,0,0,0,0,0,0,0.0,1933,1933,PE Whitelaw ,NZ
2973,2,3,0,0,0,0,0,0,0.0,1928,1930,CV Wight ,WI
2974,1,2,0,0,0,0,0,0,0.0,1953,1953,GL Wight ,WI
2975,2,4,0,0,0,0,0,0,0.0,1991,1992,KIW Wijegunawardene ,SL
2976,2,4,0,0,0,0,0,0,0.0,2005,2005,G Wijekoon ,SL
2977,1,2,0,0,0,0,0,0,0.0,1993,1993,PK Wijetunge ,SL
2978,1,1,0,0,0,0,0,0,0.0,1933,1933,CA Wiles ,WI
2979,3,5,0,0,0,0,0,0,0.0,1938,1939,LL Wilkinson ,ENG
2980,5,10,0,0,0,0,0,0,0.0,1973,1975,ET Willett ,WI
2981,1,1,0,0,0,0,0,0,0.0,1990,1990,NF Williams ,ENG
2982,2,4,0,0,0,0,0,0,0.0,2003,2003,CM Willoughby ,SA
2983,2,3,0,0,0,0,0,0,0.0,1896,1896,JT Willoughby ,SA
2984,2,4,0,0,0,0,0,0,0.0,1899,1899,CEM Wilson ,ENG
2985,1,2,0,0,0,0,0,0,0.0,1921,1921,ER Wilson ,ENG
2986,1,2,0,0,0,0,0,0,0.0,1956,1956,JW Wilson ,AUS
2987,1,1,0,0,0,0,0,0,0.0,1998,1998,P Wilson ,AUS
2988,1,1,0,0,0,0,0,0,0.0,1892,1892,CS Wimble ,SA
2989,1,2,0,0,0,0,0,0,0.0,1935,1935,KL Wishart ,WI
2990,1,2,0,0,0,0,0,0,0.0,1887,1887,R Wood ,ENG
2991,3,6,0,0,0,0,0,0,0.0,1896,1896,CW Wright ,ENG
2992,3,6,0,0,0,0,0,0,0.0,1896,1906,EG Wynyard ,ENG
2993,4,7,0,0,0,0,0,0,0.0,2018,2019,Yamin Ahmadzai ,AFG
2994,1,2,0,0,0,0,0,0,0.0,2003,2003,Yasir Ali ,PAK
2995,3,5,0,0,0,0,0,0,0.0,2007,2009,Yasir Arafat ,PAK
2996,1,2,0,0,0,0,0,0,0.0,1981,1981,B Yograj Singh ,INDIA
2997,1,2,0,0,0,0,0,0,0.0,1997,1997,S Young ,AUS
2998,4,7,0,0,0,0,0,0,0.0,1969,1987,Younis Ahmed ,PAK
2999,2,4,0,0,0,0,0,0,0.0,2019,2019,Zahir Khan ,AFG
3000,1,2,0,0,0,0,0,0,0.0,2013,2013,Ziaur Rahman ,BDESH
