,Mat,Inns,Dis,Ct,St,Ct Wk,Ct Fi,MD,D/I,start,end,name,country
0,404,397,501,402,99,383,19,5 (4ct 1st),1.261,2000,2015,KC Sangakkara ,SL
1,287,286,472,417,55,417,0,6 (6ct 0st),1.65,1996,2008,AC Gilchrist ,AUS
2,350,345,444,321,123,321,0,6 (5ct 1st),1.286,2004,2019,MS Dhoni ,INDIA
3,295,291,425,403,22,402,1,6 (6ct 0st),1.46,1998,2011,MV Boucher ,SA
4,219,217,287,214,73,214,0,5 (5ct 0st),1.3219999999999998,1990,2004,Moin Khan ,PAK
5,260,257,277,262,15,227,35,5 (5ct 0st),1.077,2002,2016,BB McCullum ,NZ
6,168,168,233,194,39,194,0,4 (4ct 0st),1.386,1988,1997,IA Healy ,AUS
7,216,215,225,181,44,179,2,5 (5ct 0st),1.046,2006,2019,Mushfiqur Rahim ,BDESH
8,166,164,220,182,38,182,0,5 (5ct 0st),1.341,1992,2003,Rashid Latif ,PAK
9,448,443,218,218,0,0,218,4 (4ct 0st),0.492,1998,2015,DPMD Jayawardene ,SL
10,344,341,210,196,14,72,124,4 (4ct 0st),0.615,1996,2011,R Dravid ,INDIA
11,189,188,207,132,75,131,1,5 (4ct 1st),1.101,1990,2004,RS Kaluwitharana ,SL
12,169,168,204,183,21,183,0,4 (4ct 0st),1.214,1981,1991,PJL Dujon ,WI
13,142,138,202,171,31,171,0,6 (6ct 0st),1.463,2012,2019,JC Buttler ,ENG
14,147,145,189,160,29,160,0,6 (5ct 1st),1.3030000000000002,1996,2004,RD Jacobs ,WI
15,157,154,188,157,31,156,1,5 (4ct 1st),1.22,2002,2017,Kamran Akmal ,PAK
16,139,137,188,181,7,181,0,5 (5ct 0st),1.372,2005,2016,D Ramdin ,WI
17,228,223,181,176,5,93,83,5 (5ct 0st),0.8109999999999999,2005,2018,AB de Villiers ,SA
18,126,124,181,170,11,170,0,5 (5ct 0st),1.459,2001,2015,BJ Haddin ,AUS
19,170,169,174,159,15,148,11,6 (6ct 0st),1.029,1989,2003,AJ Stewart ,ENG
20,213,212,173,141,32,133,8,5 (5ct 0st),0.816,1992,2003,A Flower ,ZIM
21,115,111,166,158,8,158,0,6 (5ct 1st),1.495,2013,2019,Q de Kock ,SA
22,122,121,165,148,17,148,0,5 (5ct 0st),1.3630000000000002,1991,1998,DJ Richardson ,SA
23,375,372,160,160,0,0,160,3 (3ct 0st),0.43,1995,2012,RT Ponting ,AUS
24,334,332,156,156,0,0,156,4 (4ct 0st),0.469,1985,2000,M Azharuddin ,INDIA
25,140,139,154,110,44,110,0,5 (4ct 1st),1.107,1994,2000,NR Mongia ,INDIA
26,193,193,154,125,29,96,29,5 (5ct 0st),0.797,2004,2019,BRM Taylor ,ZIM
27,150,150,147,114,33,112,2,4 (4ct 0st),0.98,2001,2012,T Taibu ,ZIM
28,179,178,141,116,25,111,5,5 (3ct 2st),0.792,1992,2002,AC Parore ,NZ
29,116,114,140,116,24,116,0,6 (6ct 0st),1.228,2007,2019,Sarfaraz Ahmed ,PAK
30,463,456,140,140,0,0,140,4 (4ct 0st),0.307,1989,2012,SR Tendulkar ,INDIA
31,228,224,137,137,0,0,137,4 (4ct 0st),0.611,2006,2019,LRPL Taylor ,NZ
32,265,260,135,135,0,5,130,4 (4ct 0st),0.519,2000,2015,Younis Khan ,PAK
33,280,276,133,133,0,0,133,4 (4ct 0st),0.481,1994,2007,SP Fleming ,NZ
34,328,324,131,131,0,0,131,3 (3ct 0st),0.4039999999999999,1996,2014,JH Kallis ,SA
35,350,347,130,130,0,0,130,3 (3ct 0st),0.374,1993,2011,M Muralitharan ,SL
36,273,270,127,127,0,0,127,3 (3ct 0st),0.47,1979,1994,AR Border ,AUS
37,398,392,127,127,0,0,127,2 (2ct 0st),0.3229999999999999,1996,2015,Shahid Afridi ,PAK
38,126,126,126,91,35,91,0,5 (3ct 2st),1.0,1995,2006,Khaled Mashud ,BDESH
39,330,325,124,123,1,5,118,3 (3ct 0st),0.381,1999,2016,TM Dilshan ,SL
40,301,294,124,124,0,0,124,3 (3ct 0st),0.421,1999,2019,CH Gayle ,WI
41,242,240,124,124,0,0,124,3 (3ct 0st),0.516,2008,2019,V Kohli ,INDIA
42,92,92,124,120,4,120,0,5 (5ct 0st),1.347,1971,1984,RW Marsh ,AUS
43,445,441,123,123,0,0,123,3 (3ct 0st),0.278,1989,2011,ST Jayasuriya ,SL
44,227,225,120,120,0,0,120,4 (4ct 0st),0.5329999999999999,1987,2003,CL Hooper ,WI
45,299,296,120,120,0,0,120,3 (3ct 0st),0.405,1990,2007,BC Lara ,WI
46,85,83,117,105,12,105,0,4 (4ct 0st),1.409,2008,2017,L Ronchi ,AUS
47,94,94,117,108,9,108,0,5 (5ct 0st),1.244,2012,2017,MS Wade ,AUS
48,378,373,113,113,0,0,113,3 (3ct 0st),0.302,1991,2007,Inzamam-ul-Haq ,PAK
49,325,324,111,111,0,0,111,3 (3ct 0st),0.342,1986,2002,SR Waugh ,AUS
50,404,397,501,402,99,383,19,5 (4ct 1st),1.261,2000,2015,KC Sangakkara ,SL
51,287,286,472,417,55,417,0,6 (6ct 0st),1.65,1996,2008,AC Gilchrist ,AUS
52,350,345,444,321,123,321,0,6 (5ct 1st),1.286,2004,2019,MS Dhoni ,INDIA
53,295,291,425,403,22,402,1,6 (6ct 0st),1.46,1998,2011,MV Boucher ,SA
54,219,217,287,214,73,214,0,5 (5ct 0st),1.3219999999999998,1990,2004,Moin Khan ,PAK
55,260,257,277,262,15,227,35,5 (5ct 0st),1.077,2002,2016,BB McCullum ,NZ
56,168,168,233,194,39,194,0,4 (4ct 0st),1.386,1988,1997,IA Healy ,AUS
57,216,215,225,181,44,179,2,5 (5ct 0st),1.046,2006,2019,Mushfiqur Rahim ,BDESH
58,166,164,220,182,38,182,0,5 (5ct 0st),1.341,1992,2003,Rashid Latif ,PAK
59,448,443,218,218,0,0,218,4 (4ct 0st),0.492,1998,2015,DPMD Jayawardene ,SL
60,344,341,210,196,14,72,124,4 (4ct 0st),0.615,1996,2011,R Dravid ,INDIA
61,189,188,207,132,75,131,1,5 (4ct 1st),1.101,1990,2004,RS Kaluwitharana ,SL
62,169,168,204,183,21,183,0,4 (4ct 0st),1.214,1981,1991,PJL Dujon ,WI
63,142,138,202,171,31,171,0,6 (6ct 0st),1.463,2012,2019,JC Buttler ,ENG
64,147,145,189,160,29,160,0,6 (5ct 1st),1.3030000000000002,1996,2004,RD Jacobs ,WI
65,157,154,188,157,31,156,1,5 (4ct 1st),1.22,2002,2017,Kamran Akmal ,PAK
66,139,137,188,181,7,181,0,5 (5ct 0st),1.372,2005,2016,D Ramdin ,WI
67,228,223,181,176,5,93,83,5 (5ct 0st),0.8109999999999999,2005,2018,AB de Villiers ,SA
68,126,124,181,170,11,170,0,5 (5ct 0st),1.459,2001,2015,BJ Haddin ,AUS
69,170,169,174,159,15,148,11,6 (6ct 0st),1.029,1989,2003,AJ Stewart ,ENG
70,213,212,173,141,32,133,8,5 (5ct 0st),0.816,1992,2003,A Flower ,ZIM
71,115,111,166,158,8,158,0,6 (5ct 1st),1.495,2013,2019,Q de Kock ,SA
72,122,121,165,148,17,148,0,5 (5ct 0st),1.3630000000000002,1991,1998,DJ Richardson ,SA
73,375,372,160,160,0,0,160,3 (3ct 0st),0.43,1995,2012,RT Ponting ,AUS
74,334,332,156,156,0,0,156,4 (4ct 0st),0.469,1985,2000,M Azharuddin ,INDIA
75,140,139,154,110,44,110,0,5 (4ct 1st),1.107,1994,2000,NR Mongia ,INDIA
76,193,193,154,125,29,96,29,5 (5ct 0st),0.797,2004,2019,BRM Taylor ,ZIM
77,150,150,147,114,33,112,2,4 (4ct 0st),0.98,2001,2012,T Taibu ,ZIM
78,179,178,141,116,25,111,5,5 (3ct 2st),0.792,1992,2002,AC Parore ,NZ
79,116,114,140,116,24,116,0,6 (6ct 0st),1.228,2007,2019,Sarfaraz Ahmed ,PAK
80,463,456,140,140,0,0,140,4 (4ct 0st),0.307,1989,2012,SR Tendulkar ,INDIA
81,228,224,137,137,0,0,137,4 (4ct 0st),0.611,2006,2019,LRPL Taylor ,NZ
82,265,260,135,135,0,5,130,4 (4ct 0st),0.519,2000,2015,Younis Khan ,PAK
83,280,276,133,133,0,0,133,4 (4ct 0st),0.481,1994,2007,SP Fleming ,NZ
84,328,324,131,131,0,0,131,3 (3ct 0st),0.4039999999999999,1996,2014,JH Kallis ,SA
85,350,347,130,130,0,0,130,3 (3ct 0st),0.374,1993,2011,M Muralitharan ,SL
86,273,270,127,127,0,0,127,3 (3ct 0st),0.47,1979,1994,AR Border ,AUS
87,398,392,127,127,0,0,127,2 (2ct 0st),0.3229999999999999,1996,2015,Shahid Afridi ,PAK
88,126,126,126,91,35,91,0,5 (3ct 2st),1.0,1995,2006,Khaled Mashud ,BDESH
89,330,325,124,123,1,5,118,3 (3ct 0st),0.381,1999,2016,TM Dilshan ,SL
90,301,294,124,124,0,0,124,3 (3ct 0st),0.421,1999,2019,CH Gayle ,WI
91,242,240,124,124,0,0,124,3 (3ct 0st),0.516,2008,2019,V Kohli ,INDIA
92,92,92,124,120,4,120,0,5 (5ct 0st),1.347,1971,1984,RW Marsh ,AUS
93,445,441,123,123,0,0,123,3 (3ct 0st),0.278,1989,2011,ST Jayasuriya ,SL
94,227,225,120,120,0,0,120,4 (4ct 0st),0.5329999999999999,1987,2003,CL Hooper ,WI
95,299,296,120,120,0,0,120,3 (3ct 0st),0.405,1990,2007,BC Lara ,WI
96,85,83,117,105,12,105,0,4 (4ct 0st),1.409,2008,2017,L Ronchi ,AUS
97,94,94,117,108,9,108,0,5 (5ct 0st),1.244,2012,2017,MS Wade ,AUS
98,378,373,113,113,0,0,113,3 (3ct 0st),0.302,1991,2007,Inzamam-ul-Haq ,PAK
99,325,324,111,111,0,0,111,3 (3ct 0st),0.342,1986,2002,SR Waugh ,AUS
100,404,397,501,402,99,383,19,5 (4ct 1st),1.261,2000,2015,KC Sangakkara ,SL
101,287,286,472,417,55,417,0,6 (6ct 0st),1.65,1996,2008,AC Gilchrist ,AUS
102,350,345,444,321,123,321,0,6 (5ct 1st),1.286,2004,2019,MS Dhoni ,INDIA
103,295,291,425,403,22,402,1,6 (6ct 0st),1.46,1998,2011,MV Boucher ,SA
104,219,217,287,214,73,214,0,5 (5ct 0st),1.3219999999999998,1990,2004,Moin Khan ,PAK
105,260,257,277,262,15,227,35,5 (5ct 0st),1.077,2002,2016,BB McCullum ,NZ
106,168,168,233,194,39,194,0,4 (4ct 0st),1.386,1988,1997,IA Healy ,AUS
107,216,215,225,181,44,179,2,5 (5ct 0st),1.046,2006,2019,Mushfiqur Rahim ,BDESH
108,166,164,220,182,38,182,0,5 (5ct 0st),1.341,1992,2003,Rashid Latif ,PAK
109,448,443,218,218,0,0,218,4 (4ct 0st),0.492,1998,2015,DPMD Jayawardene ,SL
110,344,341,210,196,14,72,124,4 (4ct 0st),0.615,1996,2011,R Dravid ,INDIA
111,189,188,207,132,75,131,1,5 (4ct 1st),1.101,1990,2004,RS Kaluwitharana ,SL
112,169,168,204,183,21,183,0,4 (4ct 0st),1.214,1981,1991,PJL Dujon ,WI
113,142,138,202,171,31,171,0,6 (6ct 0st),1.463,2012,2019,JC Buttler ,ENG
114,147,145,189,160,29,160,0,6 (5ct 1st),1.3030000000000002,1996,2004,RD Jacobs ,WI
115,157,154,188,157,31,156,1,5 (4ct 1st),1.22,2002,2017,Kamran Akmal ,PAK
116,139,137,188,181,7,181,0,5 (5ct 0st),1.372,2005,2016,D Ramdin ,WI
117,228,223,181,176,5,93,83,5 (5ct 0st),0.8109999999999999,2005,2018,AB de Villiers ,SA
118,126,124,181,170,11,170,0,5 (5ct 0st),1.459,2001,2015,BJ Haddin ,AUS
119,170,169,174,159,15,148,11,6 (6ct 0st),1.029,1989,2003,AJ Stewart ,ENG
120,213,212,173,141,32,133,8,5 (5ct 0st),0.816,1992,2003,A Flower ,ZIM
121,115,111,166,158,8,158,0,6 (5ct 1st),1.495,2013,2019,Q de Kock ,SA
122,122,121,165,148,17,148,0,5 (5ct 0st),1.3630000000000002,1991,1998,DJ Richardson ,SA
123,375,372,160,160,0,0,160,3 (3ct 0st),0.43,1995,2012,RT Ponting ,AUS
124,334,332,156,156,0,0,156,4 (4ct 0st),0.469,1985,2000,M Azharuddin ,INDIA
125,140,139,154,110,44,110,0,5 (4ct 1st),1.107,1994,2000,NR Mongia ,INDIA
126,193,193,154,125,29,96,29,5 (5ct 0st),0.797,2004,2019,BRM Taylor ,ZIM
127,150,150,147,114,33,112,2,4 (4ct 0st),0.98,2001,2012,T Taibu ,ZIM
128,179,178,141,116,25,111,5,5 (3ct 2st),0.792,1992,2002,AC Parore ,NZ
129,116,114,140,116,24,116,0,6 (6ct 0st),1.228,2007,2019,Sarfaraz Ahmed ,PAK
130,463,456,140,140,0,0,140,4 (4ct 0st),0.307,1989,2012,SR Tendulkar ,INDIA
131,228,224,137,137,0,0,137,4 (4ct 0st),0.611,2006,2019,LRPL Taylor ,NZ
132,265,260,135,135,0,5,130,4 (4ct 0st),0.519,2000,2015,Younis Khan ,PAK
133,280,276,133,133,0,0,133,4 (4ct 0st),0.481,1994,2007,SP Fleming ,NZ
134,328,324,131,131,0,0,131,3 (3ct 0st),0.4039999999999999,1996,2014,JH Kallis ,SA
135,350,347,130,130,0,0,130,3 (3ct 0st),0.374,1993,2011,M Muralitharan ,SL
136,273,270,127,127,0,0,127,3 (3ct 0st),0.47,1979,1994,AR Border ,AUS
137,398,392,127,127,0,0,127,2 (2ct 0st),0.3229999999999999,1996,2015,Shahid Afridi ,PAK
138,126,126,126,91,35,91,0,5 (3ct 2st),1.0,1995,2006,Khaled Mashud ,BDESH
139,330,325,124,123,1,5,118,3 (3ct 0st),0.381,1999,2016,TM Dilshan ,SL
140,301,294,124,124,0,0,124,3 (3ct 0st),0.421,1999,2019,CH Gayle ,WI
141,242,240,124,124,0,0,124,3 (3ct 0st),0.516,2008,2019,V Kohli ,INDIA
142,92,92,124,120,4,120,0,5 (5ct 0st),1.347,1971,1984,RW Marsh ,AUS
143,445,441,123,123,0,0,123,3 (3ct 0st),0.278,1989,2011,ST Jayasuriya ,SL
144,227,225,120,120,0,0,120,4 (4ct 0st),0.5329999999999999,1987,2003,CL Hooper ,WI
145,299,296,120,120,0,0,120,3 (3ct 0st),0.405,1990,2007,BC Lara ,WI
146,85,83,117,105,12,105,0,4 (4ct 0st),1.409,2008,2017,L Ronchi ,AUS
147,94,94,117,108,9,108,0,5 (5ct 0st),1.244,2012,2017,MS Wade ,AUS
148,378,373,113,113,0,0,113,3 (3ct 0st),0.302,1991,2007,Inzamam-ul-Haq ,PAK
149,325,324,111,111,0,0,111,3 (3ct 0st),0.342,1986,2002,SR Waugh ,AUS
150,404,397,501,402,99,383,19,5 (4ct 1st),1.261,2000,2015,KC Sangakkara ,SL
151,287,286,472,417,55,417,0,6 (6ct 0st),1.65,1996,2008,AC Gilchrist ,AUS
152,350,345,444,321,123,321,0,6 (5ct 1st),1.286,2004,2019,MS Dhoni ,INDIA
153,295,291,425,403,22,402,1,6 (6ct 0st),1.46,1998,2011,MV Boucher ,SA
154,219,217,287,214,73,214,0,5 (5ct 0st),1.3219999999999998,1990,2004,Moin Khan ,PAK
155,260,257,277,262,15,227,35,5 (5ct 0st),1.077,2002,2016,BB McCullum ,NZ
156,168,168,233,194,39,194,0,4 (4ct 0st),1.386,1988,1997,IA Healy ,AUS
157,216,215,225,181,44,179,2,5 (5ct 0st),1.046,2006,2019,Mushfiqur Rahim ,BDESH
158,166,164,220,182,38,182,0,5 (5ct 0st),1.341,1992,2003,Rashid Latif ,PAK
159,448,443,218,218,0,0,218,4 (4ct 0st),0.492,1998,2015,DPMD Jayawardene ,SL
160,344,341,210,196,14,72,124,4 (4ct 0st),0.615,1996,2011,R Dravid ,INDIA
161,189,188,207,132,75,131,1,5 (4ct 1st),1.101,1990,2004,RS Kaluwitharana ,SL
162,169,168,204,183,21,183,0,4 (4ct 0st),1.214,1981,1991,PJL Dujon ,WI
163,142,138,202,171,31,171,0,6 (6ct 0st),1.463,2012,2019,JC Buttler ,ENG
164,147,145,189,160,29,160,0,6 (5ct 1st),1.3030000000000002,1996,2004,RD Jacobs ,WI
165,157,154,188,157,31,156,1,5 (4ct 1st),1.22,2002,2017,Kamran Akmal ,PAK
166,139,137,188,181,7,181,0,5 (5ct 0st),1.372,2005,2016,D Ramdin ,WI
167,228,223,181,176,5,93,83,5 (5ct 0st),0.8109999999999999,2005,2018,AB de Villiers ,SA
168,126,124,181,170,11,170,0,5 (5ct 0st),1.459,2001,2015,BJ Haddin ,AUS
169,170,169,174,159,15,148,11,6 (6ct 0st),1.029,1989,2003,AJ Stewart ,ENG
170,213,212,173,141,32,133,8,5 (5ct 0st),0.816,1992,2003,A Flower ,ZIM
171,115,111,166,158,8,158,0,6 (5ct 1st),1.495,2013,2019,Q de Kock ,SA
172,122,121,165,148,17,148,0,5 (5ct 0st),1.3630000000000002,1991,1998,DJ Richardson ,SA
173,375,372,160,160,0,0,160,3 (3ct 0st),0.43,1995,2012,RT Ponting ,AUS
174,334,332,156,156,0,0,156,4 (4ct 0st),0.469,1985,2000,M Azharuddin ,INDIA
175,140,139,154,110,44,110,0,5 (4ct 1st),1.107,1994,2000,NR Mongia ,INDIA
176,193,193,154,125,29,96,29,5 (5ct 0st),0.797,2004,2019,BRM Taylor ,ZIM
177,150,150,147,114,33,112,2,4 (4ct 0st),0.98,2001,2012,T Taibu ,ZIM
178,179,178,141,116,25,111,5,5 (3ct 2st),0.792,1992,2002,AC Parore ,NZ
179,116,114,140,116,24,116,0,6 (6ct 0st),1.228,2007,2019,Sarfaraz Ahmed ,PAK
180,463,456,140,140,0,0,140,4 (4ct 0st),0.307,1989,2012,SR Tendulkar ,INDIA
181,228,224,137,137,0,0,137,4 (4ct 0st),0.611,2006,2019,LRPL Taylor ,NZ
182,265,260,135,135,0,5,130,4 (4ct 0st),0.519,2000,2015,Younis Khan ,PAK
183,280,276,133,133,0,0,133,4 (4ct 0st),0.481,1994,2007,SP Fleming ,NZ
184,328,324,131,131,0,0,131,3 (3ct 0st),0.4039999999999999,1996,2014,JH Kallis ,SA
185,350,347,130,130,0,0,130,3 (3ct 0st),0.374,1993,2011,M Muralitharan ,SL
186,273,270,127,127,0,0,127,3 (3ct 0st),0.47,1979,1994,AR Border ,AUS
187,398,392,127,127,0,0,127,2 (2ct 0st),0.3229999999999999,1996,2015,Shahid Afridi ,PAK
188,126,126,126,91,35,91,0,5 (3ct 2st),1.0,1995,2006,Khaled Mashud ,BDESH
189,330,325,124,123,1,5,118,3 (3ct 0st),0.381,1999,2016,TM Dilshan ,SL
190,301,294,124,124,0,0,124,3 (3ct 0st),0.421,1999,2019,CH Gayle ,WI
191,242,240,124,124,0,0,124,3 (3ct 0st),0.516,2008,2019,V Kohli ,INDIA
192,92,92,124,120,4,120,0,5 (5ct 0st),1.347,1971,1984,RW Marsh ,AUS
193,445,441,123,123,0,0,123,3 (3ct 0st),0.278,1989,2011,ST Jayasuriya ,SL
194,227,225,120,120,0,0,120,4 (4ct 0st),0.5329999999999999,1987,2003,CL Hooper ,WI
195,299,296,120,120,0,0,120,3 (3ct 0st),0.405,1990,2007,BC Lara ,WI
196,85,83,117,105,12,105,0,4 (4ct 0st),1.409,2008,2017,L Ronchi ,AUS
197,94,94,117,108,9,108,0,5 (5ct 0st),1.244,2012,2017,MS Wade ,AUS
198,378,373,113,113,0,0,113,3 (3ct 0st),0.302,1991,2007,Inzamam-ul-Haq ,PAK
199,325,324,111,111,0,0,111,3 (3ct 0st),0.342,1986,2002,SR Waugh ,AUS
200,404,397,501,402,99,383,19,5 (4ct 1st),1.261,2000,2015,KC Sangakkara ,SL
201,287,286,472,417,55,417,0,6 (6ct 0st),1.65,1996,2008,AC Gilchrist ,AUS
202,350,345,444,321,123,321,0,6 (5ct 1st),1.286,2004,2019,MS Dhoni ,INDIA
203,295,291,425,403,22,402,1,6 (6ct 0st),1.46,1998,2011,MV Boucher ,SA
204,219,217,287,214,73,214,0,5 (5ct 0st),1.3219999999999998,1990,2004,Moin Khan ,PAK
205,260,257,277,262,15,227,35,5 (5ct 0st),1.077,2002,2016,BB McCullum ,NZ
206,168,168,233,194,39,194,0,4 (4ct 0st),1.386,1988,1997,IA Healy ,AUS
207,216,215,225,181,44,179,2,5 (5ct 0st),1.046,2006,2019,Mushfiqur Rahim ,BDESH
208,166,164,220,182,38,182,0,5 (5ct 0st),1.341,1992,2003,Rashid Latif ,PAK
209,448,443,218,218,0,0,218,4 (4ct 0st),0.492,1998,2015,DPMD Jayawardene ,SL
210,344,341,210,196,14,72,124,4 (4ct 0st),0.615,1996,2011,R Dravid ,INDIA
211,189,188,207,132,75,131,1,5 (4ct 1st),1.101,1990,2004,RS Kaluwitharana ,SL
212,169,168,204,183,21,183,0,4 (4ct 0st),1.214,1981,1991,PJL Dujon ,WI
213,142,138,202,171,31,171,0,6 (6ct 0st),1.463,2012,2019,JC Buttler ,ENG
214,147,145,189,160,29,160,0,6 (5ct 1st),1.3030000000000002,1996,2004,RD Jacobs ,WI
215,157,154,188,157,31,156,1,5 (4ct 1st),1.22,2002,2017,Kamran Akmal ,PAK
216,139,137,188,181,7,181,0,5 (5ct 0st),1.372,2005,2016,D Ramdin ,WI
217,228,223,181,176,5,93,83,5 (5ct 0st),0.8109999999999999,2005,2018,AB de Villiers ,SA
218,126,124,181,170,11,170,0,5 (5ct 0st),1.459,2001,2015,BJ Haddin ,AUS
219,170,169,174,159,15,148,11,6 (6ct 0st),1.029,1989,2003,AJ Stewart ,ENG
220,213,212,173,141,32,133,8,5 (5ct 0st),0.816,1992,2003,A Flower ,ZIM
221,115,111,166,158,8,158,0,6 (5ct 1st),1.495,2013,2019,Q de Kock ,SA
222,122,121,165,148,17,148,0,5 (5ct 0st),1.3630000000000002,1991,1998,DJ Richardson ,SA
223,375,372,160,160,0,0,160,3 (3ct 0st),0.43,1995,2012,RT Ponting ,AUS
224,334,332,156,156,0,0,156,4 (4ct 0st),0.469,1985,2000,M Azharuddin ,INDIA
225,140,139,154,110,44,110,0,5 (4ct 1st),1.107,1994,2000,NR Mongia ,INDIA
226,193,193,154,125,29,96,29,5 (5ct 0st),0.797,2004,2019,BRM Taylor ,ZIM
227,150,150,147,114,33,112,2,4 (4ct 0st),0.98,2001,2012,T Taibu ,ZIM
228,179,178,141,116,25,111,5,5 (3ct 2st),0.792,1992,2002,AC Parore ,NZ
229,116,114,140,116,24,116,0,6 (6ct 0st),1.228,2007,2019,Sarfaraz Ahmed ,PAK
230,463,456,140,140,0,0,140,4 (4ct 0st),0.307,1989,2012,SR Tendulkar ,INDIA
231,228,224,137,137,0,0,137,4 (4ct 0st),0.611,2006,2019,LRPL Taylor ,NZ
232,265,260,135,135,0,5,130,4 (4ct 0st),0.519,2000,2015,Younis Khan ,PAK
233,280,276,133,133,0,0,133,4 (4ct 0st),0.481,1994,2007,SP Fleming ,NZ
234,328,324,131,131,0,0,131,3 (3ct 0st),0.4039999999999999,1996,2014,JH Kallis ,SA
235,350,347,130,130,0,0,130,3 (3ct 0st),0.374,1993,2011,M Muralitharan ,SL
236,273,270,127,127,0,0,127,3 (3ct 0st),0.47,1979,1994,AR Border ,AUS
237,398,392,127,127,0,0,127,2 (2ct 0st),0.3229999999999999,1996,2015,Shahid Afridi ,PAK
238,126,126,126,91,35,91,0,5 (3ct 2st),1.0,1995,2006,Khaled Mashud ,BDESH
239,330,325,124,123,1,5,118,3 (3ct 0st),0.381,1999,2016,TM Dilshan ,SL
240,301,294,124,124,0,0,124,3 (3ct 0st),0.421,1999,2019,CH Gayle ,WI
241,242,240,124,124,0,0,124,3 (3ct 0st),0.516,2008,2019,V Kohli ,INDIA
242,92,92,124,120,4,120,0,5 (5ct 0st),1.347,1971,1984,RW Marsh ,AUS
243,445,441,123,123,0,0,123,3 (3ct 0st),0.278,1989,2011,ST Jayasuriya ,SL
244,227,225,120,120,0,0,120,4 (4ct 0st),0.5329999999999999,1987,2003,CL Hooper ,WI
245,299,296,120,120,0,0,120,3 (3ct 0st),0.405,1990,2007,BC Lara ,WI
246,85,83,117,105,12,105,0,4 (4ct 0st),1.409,2008,2017,L Ronchi ,AUS
247,94,94,117,108,9,108,0,5 (5ct 0st),1.244,2012,2017,MS Wade ,AUS
248,378,373,113,113,0,0,113,3 (3ct 0st),0.302,1991,2007,Inzamam-ul-Haq ,PAK
249,325,324,111,111,0,0,111,3 (3ct 0st),0.342,1986,2002,SR Waugh ,AUS
250,404,397,501,402,99,383,19,5 (4ct 1st),1.261,2000,2015,KC Sangakkara ,SL
251,287,286,472,417,55,417,0,6 (6ct 0st),1.65,1996,2008,AC Gilchrist ,AUS
252,350,345,444,321,123,321,0,6 (5ct 1st),1.286,2004,2019,MS Dhoni ,INDIA
253,295,291,425,403,22,402,1,6 (6ct 0st),1.46,1998,2011,MV Boucher ,SA
254,219,217,287,214,73,214,0,5 (5ct 0st),1.3219999999999998,1990,2004,Moin Khan ,PAK
255,260,257,277,262,15,227,35,5 (5ct 0st),1.077,2002,2016,BB McCullum ,NZ
256,168,168,233,194,39,194,0,4 (4ct 0st),1.386,1988,1997,IA Healy ,AUS
257,216,215,225,181,44,179,2,5 (5ct 0st),1.046,2006,2019,Mushfiqur Rahim ,BDESH
258,166,164,220,182,38,182,0,5 (5ct 0st),1.341,1992,2003,Rashid Latif ,PAK
259,448,443,218,218,0,0,218,4 (4ct 0st),0.492,1998,2015,DPMD Jayawardene ,SL
260,344,341,210,196,14,72,124,4 (4ct 0st),0.615,1996,2011,R Dravid ,INDIA
261,189,188,207,132,75,131,1,5 (4ct 1st),1.101,1990,2004,RS Kaluwitharana ,SL
262,169,168,204,183,21,183,0,4 (4ct 0st),1.214,1981,1991,PJL Dujon ,WI
263,142,138,202,171,31,171,0,6 (6ct 0st),1.463,2012,2019,JC Buttler ,ENG
264,147,145,189,160,29,160,0,6 (5ct 1st),1.3030000000000002,1996,2004,RD Jacobs ,WI
265,157,154,188,157,31,156,1,5 (4ct 1st),1.22,2002,2017,Kamran Akmal ,PAK
266,139,137,188,181,7,181,0,5 (5ct 0st),1.372,2005,2016,D Ramdin ,WI
267,228,223,181,176,5,93,83,5 (5ct 0st),0.8109999999999999,2005,2018,AB de Villiers ,SA
268,126,124,181,170,11,170,0,5 (5ct 0st),1.459,2001,2015,BJ Haddin ,AUS
269,170,169,174,159,15,148,11,6 (6ct 0st),1.029,1989,2003,AJ Stewart ,ENG
270,213,212,173,141,32,133,8,5 (5ct 0st),0.816,1992,2003,A Flower ,ZIM
271,115,111,166,158,8,158,0,6 (5ct 1st),1.495,2013,2019,Q de Kock ,SA
272,122,121,165,148,17,148,0,5 (5ct 0st),1.3630000000000002,1991,1998,DJ Richardson ,SA
273,375,372,160,160,0,0,160,3 (3ct 0st),0.43,1995,2012,RT Ponting ,AUS
274,334,332,156,156,0,0,156,4 (4ct 0st),0.469,1985,2000,M Azharuddin ,INDIA
275,140,139,154,110,44,110,0,5 (4ct 1st),1.107,1994,2000,NR Mongia ,INDIA
276,193,193,154,125,29,96,29,5 (5ct 0st),0.797,2004,2019,BRM Taylor ,ZIM
277,150,150,147,114,33,112,2,4 (4ct 0st),0.98,2001,2012,T Taibu ,ZIM
278,179,178,141,116,25,111,5,5 (3ct 2st),0.792,1992,2002,AC Parore ,NZ
279,116,114,140,116,24,116,0,6 (6ct 0st),1.228,2007,2019,Sarfaraz Ahmed ,PAK
280,463,456,140,140,0,0,140,4 (4ct 0st),0.307,1989,2012,SR Tendulkar ,INDIA
281,228,224,137,137,0,0,137,4 (4ct 0st),0.611,2006,2019,LRPL Taylor ,NZ
282,265,260,135,135,0,5,130,4 (4ct 0st),0.519,2000,2015,Younis Khan ,PAK
283,280,276,133,133,0,0,133,4 (4ct 0st),0.481,1994,2007,SP Fleming ,NZ
284,328,324,131,131,0,0,131,3 (3ct 0st),0.4039999999999999,1996,2014,JH Kallis ,SA
285,350,347,130,130,0,0,130,3 (3ct 0st),0.374,1993,2011,M Muralitharan ,SL
286,273,270,127,127,0,0,127,3 (3ct 0st),0.47,1979,1994,AR Border ,AUS
287,398,392,127,127,0,0,127,2 (2ct 0st),0.3229999999999999,1996,2015,Shahid Afridi ,PAK
288,126,126,126,91,35,91,0,5 (3ct 2st),1.0,1995,2006,Khaled Mashud ,BDESH
289,330,325,124,123,1,5,118,3 (3ct 0st),0.381,1999,2016,TM Dilshan ,SL
290,301,294,124,124,0,0,124,3 (3ct 0st),0.421,1999,2019,CH Gayle ,WI
291,242,240,124,124,0,0,124,3 (3ct 0st),0.516,2008,2019,V Kohli ,INDIA
292,92,92,124,120,4,120,0,5 (5ct 0st),1.347,1971,1984,RW Marsh ,AUS
293,445,441,123,123,0,0,123,3 (3ct 0st),0.278,1989,2011,ST Jayasuriya ,SL
294,227,225,120,120,0,0,120,4 (4ct 0st),0.5329999999999999,1987,2003,CL Hooper ,WI
295,299,296,120,120,0,0,120,3 (3ct 0st),0.405,1990,2007,BC Lara ,WI
296,85,83,117,105,12,105,0,4 (4ct 0st),1.409,2008,2017,L Ronchi ,AUS
297,94,94,117,108,9,108,0,5 (5ct 0st),1.244,2012,2017,MS Wade ,AUS
298,378,373,113,113,0,0,113,3 (3ct 0st),0.302,1991,2007,Inzamam-ul-Haq ,PAK
299,325,324,111,111,0,0,111,3 (3ct 0st),0.342,1986,2002,SR Waugh ,AUS
300,404,397,501,402,99,383,19,5 (4ct 1st),1.261,2000,2015,KC Sangakkara ,SL
301,287,286,472,417,55,417,0,6 (6ct 0st),1.65,1996,2008,AC Gilchrist ,AUS
302,350,345,444,321,123,321,0,6 (5ct 1st),1.286,2004,2019,MS Dhoni ,INDIA
303,295,291,425,403,22,402,1,6 (6ct 0st),1.46,1998,2011,MV Boucher ,SA
304,219,217,287,214,73,214,0,5 (5ct 0st),1.3219999999999998,1990,2004,Moin Khan ,PAK
305,260,257,277,262,15,227,35,5 (5ct 0st),1.077,2002,2016,BB McCullum ,NZ
306,168,168,233,194,39,194,0,4 (4ct 0st),1.386,1988,1997,IA Healy ,AUS
307,216,215,225,181,44,179,2,5 (5ct 0st),1.046,2006,2019,Mushfiqur Rahim ,BDESH
308,166,164,220,182,38,182,0,5 (5ct 0st),1.341,1992,2003,Rashid Latif ,PAK
309,448,443,218,218,0,0,218,4 (4ct 0st),0.492,1998,2015,DPMD Jayawardene ,SL
310,344,341,210,196,14,72,124,4 (4ct 0st),0.615,1996,2011,R Dravid ,INDIA
311,189,188,207,132,75,131,1,5 (4ct 1st),1.101,1990,2004,RS Kaluwitharana ,SL
312,169,168,204,183,21,183,0,4 (4ct 0st),1.214,1981,1991,PJL Dujon ,WI
313,142,138,202,171,31,171,0,6 (6ct 0st),1.463,2012,2019,JC Buttler ,ENG
314,147,145,189,160,29,160,0,6 (5ct 1st),1.3030000000000002,1996,2004,RD Jacobs ,WI
315,157,154,188,157,31,156,1,5 (4ct 1st),1.22,2002,2017,Kamran Akmal ,PAK
316,139,137,188,181,7,181,0,5 (5ct 0st),1.372,2005,2016,D Ramdin ,WI
317,228,223,181,176,5,93,83,5 (5ct 0st),0.8109999999999999,2005,2018,AB de Villiers ,SA
318,126,124,181,170,11,170,0,5 (5ct 0st),1.459,2001,2015,BJ Haddin ,AUS
319,170,169,174,159,15,148,11,6 (6ct 0st),1.029,1989,2003,AJ Stewart ,ENG
320,213,212,173,141,32,133,8,5 (5ct 0st),0.816,1992,2003,A Flower ,ZIM
321,115,111,166,158,8,158,0,6 (5ct 1st),1.495,2013,2019,Q de Kock ,SA
322,122,121,165,148,17,148,0,5 (5ct 0st),1.3630000000000002,1991,1998,DJ Richardson ,SA
323,375,372,160,160,0,0,160,3 (3ct 0st),0.43,1995,2012,RT Ponting ,AUS
324,334,332,156,156,0,0,156,4 (4ct 0st),0.469,1985,2000,M Azharuddin ,INDIA
325,140,139,154,110,44,110,0,5 (4ct 1st),1.107,1994,2000,NR Mongia ,INDIA
326,193,193,154,125,29,96,29,5 (5ct 0st),0.797,2004,2019,BRM Taylor ,ZIM
327,150,150,147,114,33,112,2,4 (4ct 0st),0.98,2001,2012,T Taibu ,ZIM
328,179,178,141,116,25,111,5,5 (3ct 2st),0.792,1992,2002,AC Parore ,NZ
329,116,114,140,116,24,116,0,6 (6ct 0st),1.228,2007,2019,Sarfaraz Ahmed ,PAK
330,463,456,140,140,0,0,140,4 (4ct 0st),0.307,1989,2012,SR Tendulkar ,INDIA
331,228,224,137,137,0,0,137,4 (4ct 0st),0.611,2006,2019,LRPL Taylor ,NZ
332,265,260,135,135,0,5,130,4 (4ct 0st),0.519,2000,2015,Younis Khan ,PAK
333,280,276,133,133,0,0,133,4 (4ct 0st),0.481,1994,2007,SP Fleming ,NZ
334,328,324,131,131,0,0,131,3 (3ct 0st),0.4039999999999999,1996,2014,JH Kallis ,SA
335,350,347,130,130,0,0,130,3 (3ct 0st),0.374,1993,2011,M Muralitharan ,SL
336,273,270,127,127,0,0,127,3 (3ct 0st),0.47,1979,1994,AR Border ,AUS
337,398,392,127,127,0,0,127,2 (2ct 0st),0.3229999999999999,1996,2015,Shahid Afridi ,PAK
338,126,126,126,91,35,91,0,5 (3ct 2st),1.0,1995,2006,Khaled Mashud ,BDESH
339,330,325,124,123,1,5,118,3 (3ct 0st),0.381,1999,2016,TM Dilshan ,SL
340,301,294,124,124,0,0,124,3 (3ct 0st),0.421,1999,2019,CH Gayle ,WI
341,242,240,124,124,0,0,124,3 (3ct 0st),0.516,2008,2019,V Kohli ,INDIA
342,92,92,124,120,4,120,0,5 (5ct 0st),1.347,1971,1984,RW Marsh ,AUS
343,445,441,123,123,0,0,123,3 (3ct 0st),0.278,1989,2011,ST Jayasuriya ,SL
344,227,225,120,120,0,0,120,4 (4ct 0st),0.5329999999999999,1987,2003,CL Hooper ,WI
345,299,296,120,120,0,0,120,3 (3ct 0st),0.405,1990,2007,BC Lara ,WI
346,85,83,117,105,12,105,0,4 (4ct 0st),1.409,2008,2017,L Ronchi ,AUS
347,94,94,117,108,9,108,0,5 (5ct 0st),1.244,2012,2017,MS Wade ,AUS
348,378,373,113,113,0,0,113,3 (3ct 0st),0.302,1991,2007,Inzamam-ul-Haq ,PAK
349,325,324,111,111,0,0,111,3 (3ct 0st),0.342,1986,2002,SR Waugh ,AUS
350,404,397,501,402,99,383,19,5 (4ct 1st),1.261,2000,2015,KC Sangakkara ,SL
351,287,286,472,417,55,417,0,6 (6ct 0st),1.65,1996,2008,AC Gilchrist ,AUS
352,350,345,444,321,123,321,0,6 (5ct 1st),1.286,2004,2019,MS Dhoni ,INDIA
353,295,291,425,403,22,402,1,6 (6ct 0st),1.46,1998,2011,MV Boucher ,SA
354,219,217,287,214,73,214,0,5 (5ct 0st),1.3219999999999998,1990,2004,Moin Khan ,PAK
355,260,257,277,262,15,227,35,5 (5ct 0st),1.077,2002,2016,BB McCullum ,NZ
356,168,168,233,194,39,194,0,4 (4ct 0st),1.386,1988,1997,IA Healy ,AUS
357,216,215,225,181,44,179,2,5 (5ct 0st),1.046,2006,2019,Mushfiqur Rahim ,BDESH
358,166,164,220,182,38,182,0,5 (5ct 0st),1.341,1992,2003,Rashid Latif ,PAK
359,448,443,218,218,0,0,218,4 (4ct 0st),0.492,1998,2015,DPMD Jayawardene ,SL
360,344,341,210,196,14,72,124,4 (4ct 0st),0.615,1996,2011,R Dravid ,INDIA
361,189,188,207,132,75,131,1,5 (4ct 1st),1.101,1990,2004,RS Kaluwitharana ,SL
362,169,168,204,183,21,183,0,4 (4ct 0st),1.214,1981,1991,PJL Dujon ,WI
363,142,138,202,171,31,171,0,6 (6ct 0st),1.463,2012,2019,JC Buttler ,ENG
364,147,145,189,160,29,160,0,6 (5ct 1st),1.3030000000000002,1996,2004,RD Jacobs ,WI
365,157,154,188,157,31,156,1,5 (4ct 1st),1.22,2002,2017,Kamran Akmal ,PAK
366,139,137,188,181,7,181,0,5 (5ct 0st),1.372,2005,2016,D Ramdin ,WI
367,228,223,181,176,5,93,83,5 (5ct 0st),0.8109999999999999,2005,2018,AB de Villiers ,SA
368,126,124,181,170,11,170,0,5 (5ct 0st),1.459,2001,2015,BJ Haddin ,AUS
369,170,169,174,159,15,148,11,6 (6ct 0st),1.029,1989,2003,AJ Stewart ,ENG
370,213,212,173,141,32,133,8,5 (5ct 0st),0.816,1992,2003,A Flower ,ZIM
371,115,111,166,158,8,158,0,6 (5ct 1st),1.495,2013,2019,Q de Kock ,SA
372,122,121,165,148,17,148,0,5 (5ct 0st),1.3630000000000002,1991,1998,DJ Richardson ,SA
373,375,372,160,160,0,0,160,3 (3ct 0st),0.43,1995,2012,RT Ponting ,AUS
374,334,332,156,156,0,0,156,4 (4ct 0st),0.469,1985,2000,M Azharuddin ,INDIA
375,140,139,154,110,44,110,0,5 (4ct 1st),1.107,1994,2000,NR Mongia ,INDIA
376,193,193,154,125,29,96,29,5 (5ct 0st),0.797,2004,2019,BRM Taylor ,ZIM
377,150,150,147,114,33,112,2,4 (4ct 0st),0.98,2001,2012,T Taibu ,ZIM
378,179,178,141,116,25,111,5,5 (3ct 2st),0.792,1992,2002,AC Parore ,NZ
379,116,114,140,116,24,116,0,6 (6ct 0st),1.228,2007,2019,Sarfaraz Ahmed ,PAK
380,463,456,140,140,0,0,140,4 (4ct 0st),0.307,1989,2012,SR Tendulkar ,INDIA
381,228,224,137,137,0,0,137,4 (4ct 0st),0.611,2006,2019,LRPL Taylor ,NZ
382,265,260,135,135,0,5,130,4 (4ct 0st),0.519,2000,2015,Younis Khan ,PAK
383,280,276,133,133,0,0,133,4 (4ct 0st),0.481,1994,2007,SP Fleming ,NZ
384,328,324,131,131,0,0,131,3 (3ct 0st),0.4039999999999999,1996,2014,JH Kallis ,SA
385,350,347,130,130,0,0,130,3 (3ct 0st),0.374,1993,2011,M Muralitharan ,SL
386,273,270,127,127,0,0,127,3 (3ct 0st),0.47,1979,1994,AR Border ,AUS
387,398,392,127,127,0,0,127,2 (2ct 0st),0.3229999999999999,1996,2015,Shahid Afridi ,PAK
388,126,126,126,91,35,91,0,5 (3ct 2st),1.0,1995,2006,Khaled Mashud ,BDESH
389,330,325,124,123,1,5,118,3 (3ct 0st),0.381,1999,2016,TM Dilshan ,SL
390,301,294,124,124,0,0,124,3 (3ct 0st),0.421,1999,2019,CH Gayle ,WI
391,242,240,124,124,0,0,124,3 (3ct 0st),0.516,2008,2019,V Kohli ,INDIA
392,92,92,124,120,4,120,0,5 (5ct 0st),1.347,1971,1984,RW Marsh ,AUS
393,445,441,123,123,0,0,123,3 (3ct 0st),0.278,1989,2011,ST Jayasuriya ,SL
394,227,225,120,120,0,0,120,4 (4ct 0st),0.5329999999999999,1987,2003,CL Hooper ,WI
395,299,296,120,120,0,0,120,3 (3ct 0st),0.405,1990,2007,BC Lara ,WI
396,85,83,117,105,12,105,0,4 (4ct 0st),1.409,2008,2017,L Ronchi ,AUS
397,94,94,117,108,9,108,0,5 (5ct 0st),1.244,2012,2017,MS Wade ,AUS
398,378,373,113,113,0,0,113,3 (3ct 0st),0.302,1991,2007,Inzamam-ul-Haq ,PAK
399,325,324,111,111,0,0,111,3 (3ct 0st),0.342,1986,2002,SR Waugh ,AUS
400,404,397,501,402,99,383,19,5 (4ct 1st),1.261,2000,2015,KC Sangakkara ,SL
401,287,286,472,417,55,417,0,6 (6ct 0st),1.65,1996,2008,AC Gilchrist ,AUS
402,350,345,444,321,123,321,0,6 (5ct 1st),1.286,2004,2019,MS Dhoni ,INDIA
403,295,291,425,403,22,402,1,6 (6ct 0st),1.46,1998,2011,MV Boucher ,SA
404,219,217,287,214,73,214,0,5 (5ct 0st),1.3219999999999998,1990,2004,Moin Khan ,PAK
405,260,257,277,262,15,227,35,5 (5ct 0st),1.077,2002,2016,BB McCullum ,NZ
406,168,168,233,194,39,194,0,4 (4ct 0st),1.386,1988,1997,IA Healy ,AUS
407,216,215,225,181,44,179,2,5 (5ct 0st),1.046,2006,2019,Mushfiqur Rahim ,BDESH
408,166,164,220,182,38,182,0,5 (5ct 0st),1.341,1992,2003,Rashid Latif ,PAK
409,448,443,218,218,0,0,218,4 (4ct 0st),0.492,1998,2015,DPMD Jayawardene ,SL
410,344,341,210,196,14,72,124,4 (4ct 0st),0.615,1996,2011,R Dravid ,INDIA
411,189,188,207,132,75,131,1,5 (4ct 1st),1.101,1990,2004,RS Kaluwitharana ,SL
412,169,168,204,183,21,183,0,4 (4ct 0st),1.214,1981,1991,PJL Dujon ,WI
413,142,138,202,171,31,171,0,6 (6ct 0st),1.463,2012,2019,JC Buttler ,ENG
414,147,145,189,160,29,160,0,6 (5ct 1st),1.3030000000000002,1996,2004,RD Jacobs ,WI
415,157,154,188,157,31,156,1,5 (4ct 1st),1.22,2002,2017,Kamran Akmal ,PAK
416,139,137,188,181,7,181,0,5 (5ct 0st),1.372,2005,2016,D Ramdin ,WI
417,228,223,181,176,5,93,83,5 (5ct 0st),0.8109999999999999,2005,2018,AB de Villiers ,SA
418,126,124,181,170,11,170,0,5 (5ct 0st),1.459,2001,2015,BJ Haddin ,AUS
419,170,169,174,159,15,148,11,6 (6ct 0st),1.029,1989,2003,AJ Stewart ,ENG
420,213,212,173,141,32,133,8,5 (5ct 0st),0.816,1992,2003,A Flower ,ZIM
421,115,111,166,158,8,158,0,6 (5ct 1st),1.495,2013,2019,Q de Kock ,SA
422,122,121,165,148,17,148,0,5 (5ct 0st),1.3630000000000002,1991,1998,DJ Richardson ,SA
423,375,372,160,160,0,0,160,3 (3ct 0st),0.43,1995,2012,RT Ponting ,AUS
424,334,332,156,156,0,0,156,4 (4ct 0st),0.469,1985,2000,M Azharuddin ,INDIA
425,140,139,154,110,44,110,0,5 (4ct 1st),1.107,1994,2000,NR Mongia ,INDIA
426,193,193,154,125,29,96,29,5 (5ct 0st),0.797,2004,2019,BRM Taylor ,ZIM
427,150,150,147,114,33,112,2,4 (4ct 0st),0.98,2001,2012,T Taibu ,ZIM
428,179,178,141,116,25,111,5,5 (3ct 2st),0.792,1992,2002,AC Parore ,NZ
429,116,114,140,116,24,116,0,6 (6ct 0st),1.228,2007,2019,Sarfaraz Ahmed ,PAK
430,463,456,140,140,0,0,140,4 (4ct 0st),0.307,1989,2012,SR Tendulkar ,INDIA
431,228,224,137,137,0,0,137,4 (4ct 0st),0.611,2006,2019,LRPL Taylor ,NZ
432,265,260,135,135,0,5,130,4 (4ct 0st),0.519,2000,2015,Younis Khan ,PAK
433,280,276,133,133,0,0,133,4 (4ct 0st),0.481,1994,2007,SP Fleming ,NZ
434,328,324,131,131,0,0,131,3 (3ct 0st),0.4039999999999999,1996,2014,JH Kallis ,SA
435,350,347,130,130,0,0,130,3 (3ct 0st),0.374,1993,2011,M Muralitharan ,SL
436,273,270,127,127,0,0,127,3 (3ct 0st),0.47,1979,1994,AR Border ,AUS
437,398,392,127,127,0,0,127,2 (2ct 0st),0.3229999999999999,1996,2015,Shahid Afridi ,PAK
438,126,126,126,91,35,91,0,5 (3ct 2st),1.0,1995,2006,Khaled Mashud ,BDESH
439,330,325,124,123,1,5,118,3 (3ct 0st),0.381,1999,2016,TM Dilshan ,SL
440,301,294,124,124,0,0,124,3 (3ct 0st),0.421,1999,2019,CH Gayle ,WI
441,242,240,124,124,0,0,124,3 (3ct 0st),0.516,2008,2019,V Kohli ,INDIA
442,92,92,124,120,4,120,0,5 (5ct 0st),1.347,1971,1984,RW Marsh ,AUS
443,445,441,123,123,0,0,123,3 (3ct 0st),0.278,1989,2011,ST Jayasuriya ,SL
444,227,225,120,120,0,0,120,4 (4ct 0st),0.5329999999999999,1987,2003,CL Hooper ,WI
445,299,296,120,120,0,0,120,3 (3ct 0st),0.405,1990,2007,BC Lara ,WI
446,85,83,117,105,12,105,0,4 (4ct 0st),1.409,2008,2017,L Ronchi ,AUS
447,94,94,117,108,9,108,0,5 (5ct 0st),1.244,2012,2017,MS Wade ,AUS
448,378,373,113,113,0,0,113,3 (3ct 0st),0.302,1991,2007,Inzamam-ul-Haq ,PAK
449,325,324,111,111,0,0,111,3 (3ct 0st),0.342,1986,2002,SR Waugh ,AUS
450,404,397,501,402,99,383,19,5 (4ct 1st),1.261,2000,2015,KC Sangakkara ,SL
451,287,286,472,417,55,417,0,6 (6ct 0st),1.65,1996,2008,AC Gilchrist ,AUS
452,350,345,444,321,123,321,0,6 (5ct 1st),1.286,2004,2019,MS Dhoni ,INDIA
453,295,291,425,403,22,402,1,6 (6ct 0st),1.46,1998,2011,MV Boucher ,SA
454,219,217,287,214,73,214,0,5 (5ct 0st),1.3219999999999998,1990,2004,Moin Khan ,PAK
455,260,257,277,262,15,227,35,5 (5ct 0st),1.077,2002,2016,BB McCullum ,NZ
456,168,168,233,194,39,194,0,4 (4ct 0st),1.386,1988,1997,IA Healy ,AUS
457,216,215,225,181,44,179,2,5 (5ct 0st),1.046,2006,2019,Mushfiqur Rahim ,BDESH
458,166,164,220,182,38,182,0,5 (5ct 0st),1.341,1992,2003,Rashid Latif ,PAK
459,448,443,218,218,0,0,218,4 (4ct 0st),0.492,1998,2015,DPMD Jayawardene ,SL
460,344,341,210,196,14,72,124,4 (4ct 0st),0.615,1996,2011,R Dravid ,INDIA
461,189,188,207,132,75,131,1,5 (4ct 1st),1.101,1990,2004,RS Kaluwitharana ,SL
462,169,168,204,183,21,183,0,4 (4ct 0st),1.214,1981,1991,PJL Dujon ,WI
463,142,138,202,171,31,171,0,6 (6ct 0st),1.463,2012,2019,JC Buttler ,ENG
464,147,145,189,160,29,160,0,6 (5ct 1st),1.3030000000000002,1996,2004,RD Jacobs ,WI
465,157,154,188,157,31,156,1,5 (4ct 1st),1.22,2002,2017,Kamran Akmal ,PAK
466,139,137,188,181,7,181,0,5 (5ct 0st),1.372,2005,2016,D Ramdin ,WI
467,228,223,181,176,5,93,83,5 (5ct 0st),0.8109999999999999,2005,2018,AB de Villiers ,SA
468,126,124,181,170,11,170,0,5 (5ct 0st),1.459,2001,2015,BJ Haddin ,AUS
469,170,169,174,159,15,148,11,6 (6ct 0st),1.029,1989,2003,AJ Stewart ,ENG
470,213,212,173,141,32,133,8,5 (5ct 0st),0.816,1992,2003,A Flower ,ZIM
471,115,111,166,158,8,158,0,6 (5ct 1st),1.495,2013,2019,Q de Kock ,SA
472,122,121,165,148,17,148,0,5 (5ct 0st),1.3630000000000002,1991,1998,DJ Richardson ,SA
473,375,372,160,160,0,0,160,3 (3ct 0st),0.43,1995,2012,RT Ponting ,AUS
474,334,332,156,156,0,0,156,4 (4ct 0st),0.469,1985,2000,M Azharuddin ,INDIA
475,140,139,154,110,44,110,0,5 (4ct 1st),1.107,1994,2000,NR Mongia ,INDIA
476,193,193,154,125,29,96,29,5 (5ct 0st),0.797,2004,2019,BRM Taylor ,ZIM
477,150,150,147,114,33,112,2,4 (4ct 0st),0.98,2001,2012,T Taibu ,ZIM
478,179,178,141,116,25,111,5,5 (3ct 2st),0.792,1992,2002,AC Parore ,NZ
479,116,114,140,116,24,116,0,6 (6ct 0st),1.228,2007,2019,Sarfaraz Ahmed ,PAK
480,463,456,140,140,0,0,140,4 (4ct 0st),0.307,1989,2012,SR Tendulkar ,INDIA
481,228,224,137,137,0,0,137,4 (4ct 0st),0.611,2006,2019,LRPL Taylor ,NZ
482,265,260,135,135,0,5,130,4 (4ct 0st),0.519,2000,2015,Younis Khan ,PAK
483,280,276,133,133,0,0,133,4 (4ct 0st),0.481,1994,2007,SP Fleming ,NZ
484,328,324,131,131,0,0,131,3 (3ct 0st),0.4039999999999999,1996,2014,JH Kallis ,SA
485,350,347,130,130,0,0,130,3 (3ct 0st),0.374,1993,2011,M Muralitharan ,SL
486,273,270,127,127,0,0,127,3 (3ct 0st),0.47,1979,1994,AR Border ,AUS
487,398,392,127,127,0,0,127,2 (2ct 0st),0.3229999999999999,1996,2015,Shahid Afridi ,PAK
488,126,126,126,91,35,91,0,5 (3ct 2st),1.0,1995,2006,Khaled Mashud ,BDESH
489,330,325,124,123,1,5,118,3 (3ct 0st),0.381,1999,2016,TM Dilshan ,SL
490,301,294,124,124,0,0,124,3 (3ct 0st),0.421,1999,2019,CH Gayle ,WI
491,242,240,124,124,0,0,124,3 (3ct 0st),0.516,2008,2019,V Kohli ,INDIA
492,92,92,124,120,4,120,0,5 (5ct 0st),1.347,1971,1984,RW Marsh ,AUS
493,445,441,123,123,0,0,123,3 (3ct 0st),0.278,1989,2011,ST Jayasuriya ,SL
494,227,225,120,120,0,0,120,4 (4ct 0st),0.5329999999999999,1987,2003,CL Hooper ,WI
495,299,296,120,120,0,0,120,3 (3ct 0st),0.405,1990,2007,BC Lara ,WI
496,85,83,117,105,12,105,0,4 (4ct 0st),1.409,2008,2017,L Ronchi ,AUS
497,94,94,117,108,9,108,0,5 (5ct 0st),1.244,2012,2017,MS Wade ,AUS
498,378,373,113,113,0,0,113,3 (3ct 0st),0.302,1991,2007,Inzamam-ul-Haq ,PAK
499,325,324,111,111,0,0,111,3 (3ct 0st),0.342,1986,2002,SR Waugh ,AUS
500,404,397,501,402,99,383,19,5 (4ct 1st),1.261,2000,2015,KC Sangakkara ,SL
501,287,286,472,417,55,417,0,6 (6ct 0st),1.65,1996,2008,AC Gilchrist ,AUS
502,350,345,444,321,123,321,0,6 (5ct 1st),1.286,2004,2019,MS Dhoni ,INDIA
503,295,291,425,403,22,402,1,6 (6ct 0st),1.46,1998,2011,MV Boucher ,SA
504,219,217,287,214,73,214,0,5 (5ct 0st),1.3219999999999998,1990,2004,Moin Khan ,PAK
505,260,257,277,262,15,227,35,5 (5ct 0st),1.077,2002,2016,BB McCullum ,NZ
506,168,168,233,194,39,194,0,4 (4ct 0st),1.386,1988,1997,IA Healy ,AUS
507,216,215,225,181,44,179,2,5 (5ct 0st),1.046,2006,2019,Mushfiqur Rahim ,BDESH
508,166,164,220,182,38,182,0,5 (5ct 0st),1.341,1992,2003,Rashid Latif ,PAK
509,448,443,218,218,0,0,218,4 (4ct 0st),0.492,1998,2015,DPMD Jayawardene ,SL
510,344,341,210,196,14,72,124,4 (4ct 0st),0.615,1996,2011,R Dravid ,INDIA
511,189,188,207,132,75,131,1,5 (4ct 1st),1.101,1990,2004,RS Kaluwitharana ,SL
512,169,168,204,183,21,183,0,4 (4ct 0st),1.214,1981,1991,PJL Dujon ,WI
513,142,138,202,171,31,171,0,6 (6ct 0st),1.463,2012,2019,JC Buttler ,ENG
514,147,145,189,160,29,160,0,6 (5ct 1st),1.3030000000000002,1996,2004,RD Jacobs ,WI
515,157,154,188,157,31,156,1,5 (4ct 1st),1.22,2002,2017,Kamran Akmal ,PAK
516,139,137,188,181,7,181,0,5 (5ct 0st),1.372,2005,2016,D Ramdin ,WI
517,228,223,181,176,5,93,83,5 (5ct 0st),0.8109999999999999,2005,2018,AB de Villiers ,SA
518,126,124,181,170,11,170,0,5 (5ct 0st),1.459,2001,2015,BJ Haddin ,AUS
519,170,169,174,159,15,148,11,6 (6ct 0st),1.029,1989,2003,AJ Stewart ,ENG
520,213,212,173,141,32,133,8,5 (5ct 0st),0.816,1992,2003,A Flower ,ZIM
521,115,111,166,158,8,158,0,6 (5ct 1st),1.495,2013,2019,Q de Kock ,SA
522,122,121,165,148,17,148,0,5 (5ct 0st),1.3630000000000002,1991,1998,DJ Richardson ,SA
523,375,372,160,160,0,0,160,3 (3ct 0st),0.43,1995,2012,RT Ponting ,AUS
524,334,332,156,156,0,0,156,4 (4ct 0st),0.469,1985,2000,M Azharuddin ,INDIA
525,140,139,154,110,44,110,0,5 (4ct 1st),1.107,1994,2000,NR Mongia ,INDIA
526,193,193,154,125,29,96,29,5 (5ct 0st),0.797,2004,2019,BRM Taylor ,ZIM
527,150,150,147,114,33,112,2,4 (4ct 0st),0.98,2001,2012,T Taibu ,ZIM
528,179,178,141,116,25,111,5,5 (3ct 2st),0.792,1992,2002,AC Parore ,NZ
529,116,114,140,116,24,116,0,6 (6ct 0st),1.228,2007,2019,Sarfaraz Ahmed ,PAK
530,463,456,140,140,0,0,140,4 (4ct 0st),0.307,1989,2012,SR Tendulkar ,INDIA
531,228,224,137,137,0,0,137,4 (4ct 0st),0.611,2006,2019,LRPL Taylor ,NZ
532,265,260,135,135,0,5,130,4 (4ct 0st),0.519,2000,2015,Younis Khan ,PAK
533,280,276,133,133,0,0,133,4 (4ct 0st),0.481,1994,2007,SP Fleming ,NZ
534,328,324,131,131,0,0,131,3 (3ct 0st),0.4039999999999999,1996,2014,JH Kallis ,SA
535,350,347,130,130,0,0,130,3 (3ct 0st),0.374,1993,2011,M Muralitharan ,SL
536,273,270,127,127,0,0,127,3 (3ct 0st),0.47,1979,1994,AR Border ,AUS
537,398,392,127,127,0,0,127,2 (2ct 0st),0.3229999999999999,1996,2015,Shahid Afridi ,PAK
538,126,126,126,91,35,91,0,5 (3ct 2st),1.0,1995,2006,Khaled Mashud ,BDESH
539,330,325,124,123,1,5,118,3 (3ct 0st),0.381,1999,2016,TM Dilshan ,SL
540,301,294,124,124,0,0,124,3 (3ct 0st),0.421,1999,2019,CH Gayle ,WI
541,242,240,124,124,0,0,124,3 (3ct 0st),0.516,2008,2019,V Kohli ,INDIA
542,92,92,124,120,4,120,0,5 (5ct 0st),1.347,1971,1984,RW Marsh ,AUS
543,445,441,123,123,0,0,123,3 (3ct 0st),0.278,1989,2011,ST Jayasuriya ,SL
544,227,225,120,120,0,0,120,4 (4ct 0st),0.5329999999999999,1987,2003,CL Hooper ,WI
545,299,296,120,120,0,0,120,3 (3ct 0st),0.405,1990,2007,BC Lara ,WI
546,85,83,117,105,12,105,0,4 (4ct 0st),1.409,2008,2017,L Ronchi ,AUS
547,94,94,117,108,9,108,0,5 (5ct 0st),1.244,2012,2017,MS Wade ,AUS
548,378,373,113,113,0,0,113,3 (3ct 0st),0.302,1991,2007,Inzamam-ul-Haq ,PAK
549,325,324,111,111,0,0,111,3 (3ct 0st),0.342,1986,2002,SR Waugh ,AUS
550,404,397,501,402,99,383,19,5 (4ct 1st),1.261,2000,2015,KC Sangakkara ,SL
551,287,286,472,417,55,417,0,6 (6ct 0st),1.65,1996,2008,AC Gilchrist ,AUS
552,350,345,444,321,123,321,0,6 (5ct 1st),1.286,2004,2019,MS Dhoni ,INDIA
553,295,291,425,403,22,402,1,6 (6ct 0st),1.46,1998,2011,MV Boucher ,SA
554,219,217,287,214,73,214,0,5 (5ct 0st),1.3219999999999998,1990,2004,Moin Khan ,PAK
555,260,257,277,262,15,227,35,5 (5ct 0st),1.077,2002,2016,BB McCullum ,NZ
556,168,168,233,194,39,194,0,4 (4ct 0st),1.386,1988,1997,IA Healy ,AUS
557,216,215,225,181,44,179,2,5 (5ct 0st),1.046,2006,2019,Mushfiqur Rahim ,BDESH
558,166,164,220,182,38,182,0,5 (5ct 0st),1.341,1992,2003,Rashid Latif ,PAK
559,448,443,218,218,0,0,218,4 (4ct 0st),0.492,1998,2015,DPMD Jayawardene ,SL
560,344,341,210,196,14,72,124,4 (4ct 0st),0.615,1996,2011,R Dravid ,INDIA
561,189,188,207,132,75,131,1,5 (4ct 1st),1.101,1990,2004,RS Kaluwitharana ,SL
562,169,168,204,183,21,183,0,4 (4ct 0st),1.214,1981,1991,PJL Dujon ,WI
563,142,138,202,171,31,171,0,6 (6ct 0st),1.463,2012,2019,JC Buttler ,ENG
564,147,145,189,160,29,160,0,6 (5ct 1st),1.3030000000000002,1996,2004,RD Jacobs ,WI
565,157,154,188,157,31,156,1,5 (4ct 1st),1.22,2002,2017,Kamran Akmal ,PAK
566,139,137,188,181,7,181,0,5 (5ct 0st),1.372,2005,2016,D Ramdin ,WI
567,228,223,181,176,5,93,83,5 (5ct 0st),0.8109999999999999,2005,2018,AB de Villiers ,SA
568,126,124,181,170,11,170,0,5 (5ct 0st),1.459,2001,2015,BJ Haddin ,AUS
569,170,169,174,159,15,148,11,6 (6ct 0st),1.029,1989,2003,AJ Stewart ,ENG
570,213,212,173,141,32,133,8,5 (5ct 0st),0.816,1992,2003,A Flower ,ZIM
571,115,111,166,158,8,158,0,6 (5ct 1st),1.495,2013,2019,Q de Kock ,SA
572,122,121,165,148,17,148,0,5 (5ct 0st),1.3630000000000002,1991,1998,DJ Richardson ,SA
573,375,372,160,160,0,0,160,3 (3ct 0st),0.43,1995,2012,RT Ponting ,AUS
574,334,332,156,156,0,0,156,4 (4ct 0st),0.469,1985,2000,M Azharuddin ,INDIA
575,140,139,154,110,44,110,0,5 (4ct 1st),1.107,1994,2000,NR Mongia ,INDIA
576,193,193,154,125,29,96,29,5 (5ct 0st),0.797,2004,2019,BRM Taylor ,ZIM
577,150,150,147,114,33,112,2,4 (4ct 0st),0.98,2001,2012,T Taibu ,ZIM
578,179,178,141,116,25,111,5,5 (3ct 2st),0.792,1992,2002,AC Parore ,NZ
579,116,114,140,116,24,116,0,6 (6ct 0st),1.228,2007,2019,Sarfaraz Ahmed ,PAK
580,463,456,140,140,0,0,140,4 (4ct 0st),0.307,1989,2012,SR Tendulkar ,INDIA
581,228,224,137,137,0,0,137,4 (4ct 0st),0.611,2006,2019,LRPL Taylor ,NZ
582,265,260,135,135,0,5,130,4 (4ct 0st),0.519,2000,2015,Younis Khan ,PAK
583,280,276,133,133,0,0,133,4 (4ct 0st),0.481,1994,2007,SP Fleming ,NZ
584,328,324,131,131,0,0,131,3 (3ct 0st),0.4039999999999999,1996,2014,JH Kallis ,SA
585,350,347,130,130,0,0,130,3 (3ct 0st),0.374,1993,2011,M Muralitharan ,SL
586,273,270,127,127,0,0,127,3 (3ct 0st),0.47,1979,1994,AR Border ,AUS
587,398,392,127,127,0,0,127,2 (2ct 0st),0.3229999999999999,1996,2015,Shahid Afridi ,PAK
588,126,126,126,91,35,91,0,5 (3ct 2st),1.0,1995,2006,Khaled Mashud ,BDESH
589,330,325,124,123,1,5,118,3 (3ct 0st),0.381,1999,2016,TM Dilshan ,SL
590,301,294,124,124,0,0,124,3 (3ct 0st),0.421,1999,2019,CH Gayle ,WI
591,242,240,124,124,0,0,124,3 (3ct 0st),0.516,2008,2019,V Kohli ,INDIA
592,92,92,124,120,4,120,0,5 (5ct 0st),1.347,1971,1984,RW Marsh ,AUS
593,445,441,123,123,0,0,123,3 (3ct 0st),0.278,1989,2011,ST Jayasuriya ,SL
594,227,225,120,120,0,0,120,4 (4ct 0st),0.5329999999999999,1987,2003,CL Hooper ,WI
595,299,296,120,120,0,0,120,3 (3ct 0st),0.405,1990,2007,BC Lara ,WI
596,85,83,117,105,12,105,0,4 (4ct 0st),1.409,2008,2017,L Ronchi ,AUS
597,94,94,117,108,9,108,0,5 (5ct 0st),1.244,2012,2017,MS Wade ,AUS
598,378,373,113,113,0,0,113,3 (3ct 0st),0.302,1991,2007,Inzamam-ul-Haq ,PAK
599,325,324,111,111,0,0,111,3 (3ct 0st),0.342,1986,2002,SR Waugh ,AUS
600,404,397,501,402,99,383,19,5 (4ct 1st),1.261,2000,2015,KC Sangakkara ,SL
601,287,286,472,417,55,417,0,6 (6ct 0st),1.65,1996,2008,AC Gilchrist ,AUS
602,350,345,444,321,123,321,0,6 (5ct 1st),1.286,2004,2019,MS Dhoni ,INDIA
603,295,291,425,403,22,402,1,6 (6ct 0st),1.46,1998,2011,MV Boucher ,SA
604,219,217,287,214,73,214,0,5 (5ct 0st),1.3219999999999998,1990,2004,Moin Khan ,PAK
605,260,257,277,262,15,227,35,5 (5ct 0st),1.077,2002,2016,BB McCullum ,NZ
606,168,168,233,194,39,194,0,4 (4ct 0st),1.386,1988,1997,IA Healy ,AUS
607,216,215,225,181,44,179,2,5 (5ct 0st),1.046,2006,2019,Mushfiqur Rahim ,BDESH
608,166,164,220,182,38,182,0,5 (5ct 0st),1.341,1992,2003,Rashid Latif ,PAK
609,448,443,218,218,0,0,218,4 (4ct 0st),0.492,1998,2015,DPMD Jayawardene ,SL
610,344,341,210,196,14,72,124,4 (4ct 0st),0.615,1996,2011,R Dravid ,INDIA
611,189,188,207,132,75,131,1,5 (4ct 1st),1.101,1990,2004,RS Kaluwitharana ,SL
612,169,168,204,183,21,183,0,4 (4ct 0st),1.214,1981,1991,PJL Dujon ,WI
613,142,138,202,171,31,171,0,6 (6ct 0st),1.463,2012,2019,JC Buttler ,ENG
614,147,145,189,160,29,160,0,6 (5ct 1st),1.3030000000000002,1996,2004,RD Jacobs ,WI
615,157,154,188,157,31,156,1,5 (4ct 1st),1.22,2002,2017,Kamran Akmal ,PAK
616,139,137,188,181,7,181,0,5 (5ct 0st),1.372,2005,2016,D Ramdin ,WI
617,228,223,181,176,5,93,83,5 (5ct 0st),0.8109999999999999,2005,2018,AB de Villiers ,SA
618,126,124,181,170,11,170,0,5 (5ct 0st),1.459,2001,2015,BJ Haddin ,AUS
619,170,169,174,159,15,148,11,6 (6ct 0st),1.029,1989,2003,AJ Stewart ,ENG
620,213,212,173,141,32,133,8,5 (5ct 0st),0.816,1992,2003,A Flower ,ZIM
621,115,111,166,158,8,158,0,6 (5ct 1st),1.495,2013,2019,Q de Kock ,SA
622,122,121,165,148,17,148,0,5 (5ct 0st),1.3630000000000002,1991,1998,DJ Richardson ,SA
623,375,372,160,160,0,0,160,3 (3ct 0st),0.43,1995,2012,RT Ponting ,AUS
624,334,332,156,156,0,0,156,4 (4ct 0st),0.469,1985,2000,M Azharuddin ,INDIA
625,140,139,154,110,44,110,0,5 (4ct 1st),1.107,1994,2000,NR Mongia ,INDIA
626,193,193,154,125,29,96,29,5 (5ct 0st),0.797,2004,2019,BRM Taylor ,ZIM
627,150,150,147,114,33,112,2,4 (4ct 0st),0.98,2001,2012,T Taibu ,ZIM
628,179,178,141,116,25,111,5,5 (3ct 2st),0.792,1992,2002,AC Parore ,NZ
629,116,114,140,116,24,116,0,6 (6ct 0st),1.228,2007,2019,Sarfaraz Ahmed ,PAK
630,463,456,140,140,0,0,140,4 (4ct 0st),0.307,1989,2012,SR Tendulkar ,INDIA
631,228,224,137,137,0,0,137,4 (4ct 0st),0.611,2006,2019,LRPL Taylor ,NZ
632,265,260,135,135,0,5,130,4 (4ct 0st),0.519,2000,2015,Younis Khan ,PAK
633,280,276,133,133,0,0,133,4 (4ct 0st),0.481,1994,2007,SP Fleming ,NZ
634,328,324,131,131,0,0,131,3 (3ct 0st),0.4039999999999999,1996,2014,JH Kallis ,SA
635,350,347,130,130,0,0,130,3 (3ct 0st),0.374,1993,2011,M Muralitharan ,SL
636,273,270,127,127,0,0,127,3 (3ct 0st),0.47,1979,1994,AR Border ,AUS
637,398,392,127,127,0,0,127,2 (2ct 0st),0.3229999999999999,1996,2015,Shahid Afridi ,PAK
638,126,126,126,91,35,91,0,5 (3ct 2st),1.0,1995,2006,Khaled Mashud ,BDESH
639,330,325,124,123,1,5,118,3 (3ct 0st),0.381,1999,2016,TM Dilshan ,SL
640,301,294,124,124,0,0,124,3 (3ct 0st),0.421,1999,2019,CH Gayle ,WI
641,242,240,124,124,0,0,124,3 (3ct 0st),0.516,2008,2019,V Kohli ,INDIA
642,92,92,124,120,4,120,0,5 (5ct 0st),1.347,1971,1984,RW Marsh ,AUS
643,445,441,123,123,0,0,123,3 (3ct 0st),0.278,1989,2011,ST Jayasuriya ,SL
644,227,225,120,120,0,0,120,4 (4ct 0st),0.5329999999999999,1987,2003,CL Hooper ,WI
645,299,296,120,120,0,0,120,3 (3ct 0st),0.405,1990,2007,BC Lara ,WI
646,85,83,117,105,12,105,0,4 (4ct 0st),1.409,2008,2017,L Ronchi ,AUS
647,94,94,117,108,9,108,0,5 (5ct 0st),1.244,2012,2017,MS Wade ,AUS
648,378,373,113,113,0,0,113,3 (3ct 0st),0.302,1991,2007,Inzamam-ul-Haq ,PAK
649,325,324,111,111,0,0,111,3 (3ct 0st),0.342,1986,2002,SR Waugh ,AUS
650,404,397,501,402,99,383,19,5 (4ct 1st),1.261,2000,2015,KC Sangakkara ,SL
651,287,286,472,417,55,417,0,6 (6ct 0st),1.65,1996,2008,AC Gilchrist ,AUS
652,350,345,444,321,123,321,0,6 (5ct 1st),1.286,2004,2019,MS Dhoni ,INDIA
653,295,291,425,403,22,402,1,6 (6ct 0st),1.46,1998,2011,MV Boucher ,SA
654,219,217,287,214,73,214,0,5 (5ct 0st),1.3219999999999998,1990,2004,Moin Khan ,PAK
655,260,257,277,262,15,227,35,5 (5ct 0st),1.077,2002,2016,BB McCullum ,NZ
656,168,168,233,194,39,194,0,4 (4ct 0st),1.386,1988,1997,IA Healy ,AUS
657,216,215,225,181,44,179,2,5 (5ct 0st),1.046,2006,2019,Mushfiqur Rahim ,BDESH
658,166,164,220,182,38,182,0,5 (5ct 0st),1.341,1992,2003,Rashid Latif ,PAK
659,448,443,218,218,0,0,218,4 (4ct 0st),0.492,1998,2015,DPMD Jayawardene ,SL
660,344,341,210,196,14,72,124,4 (4ct 0st),0.615,1996,2011,R Dravid ,INDIA
661,189,188,207,132,75,131,1,5 (4ct 1st),1.101,1990,2004,RS Kaluwitharana ,SL
662,169,168,204,183,21,183,0,4 (4ct 0st),1.214,1981,1991,PJL Dujon ,WI
663,142,138,202,171,31,171,0,6 (6ct 0st),1.463,2012,2019,JC Buttler ,ENG
664,147,145,189,160,29,160,0,6 (5ct 1st),1.3030000000000002,1996,2004,RD Jacobs ,WI
665,157,154,188,157,31,156,1,5 (4ct 1st),1.22,2002,2017,Kamran Akmal ,PAK
666,139,137,188,181,7,181,0,5 (5ct 0st),1.372,2005,2016,D Ramdin ,WI
667,228,223,181,176,5,93,83,5 (5ct 0st),0.8109999999999999,2005,2018,AB de Villiers ,SA
668,126,124,181,170,11,170,0,5 (5ct 0st),1.459,2001,2015,BJ Haddin ,AUS
669,170,169,174,159,15,148,11,6 (6ct 0st),1.029,1989,2003,AJ Stewart ,ENG
670,213,212,173,141,32,133,8,5 (5ct 0st),0.816,1992,2003,A Flower ,ZIM
671,115,111,166,158,8,158,0,6 (5ct 1st),1.495,2013,2019,Q de Kock ,SA
672,122,121,165,148,17,148,0,5 (5ct 0st),1.3630000000000002,1991,1998,DJ Richardson ,SA
673,375,372,160,160,0,0,160,3 (3ct 0st),0.43,1995,2012,RT Ponting ,AUS
674,334,332,156,156,0,0,156,4 (4ct 0st),0.469,1985,2000,M Azharuddin ,INDIA
675,140,139,154,110,44,110,0,5 (4ct 1st),1.107,1994,2000,NR Mongia ,INDIA
676,193,193,154,125,29,96,29,5 (5ct 0st),0.797,2004,2019,BRM Taylor ,ZIM
677,150,150,147,114,33,112,2,4 (4ct 0st),0.98,2001,2012,T Taibu ,ZIM
678,179,178,141,116,25,111,5,5 (3ct 2st),0.792,1992,2002,AC Parore ,NZ
679,116,114,140,116,24,116,0,6 (6ct 0st),1.228,2007,2019,Sarfaraz Ahmed ,PAK
680,463,456,140,140,0,0,140,4 (4ct 0st),0.307,1989,2012,SR Tendulkar ,INDIA
681,228,224,137,137,0,0,137,4 (4ct 0st),0.611,2006,2019,LRPL Taylor ,NZ
682,265,260,135,135,0,5,130,4 (4ct 0st),0.519,2000,2015,Younis Khan ,PAK
683,280,276,133,133,0,0,133,4 (4ct 0st),0.481,1994,2007,SP Fleming ,NZ
684,328,324,131,131,0,0,131,3 (3ct 0st),0.4039999999999999,1996,2014,JH Kallis ,SA
685,350,347,130,130,0,0,130,3 (3ct 0st),0.374,1993,2011,M Muralitharan ,SL
686,273,270,127,127,0,0,127,3 (3ct 0st),0.47,1979,1994,AR Border ,AUS
687,398,392,127,127,0,0,127,2 (2ct 0st),0.3229999999999999,1996,2015,Shahid Afridi ,PAK
688,126,126,126,91,35,91,0,5 (3ct 2st),1.0,1995,2006,Khaled Mashud ,BDESH
689,330,325,124,123,1,5,118,3 (3ct 0st),0.381,1999,2016,TM Dilshan ,SL
690,301,294,124,124,0,0,124,3 (3ct 0st),0.421,1999,2019,CH Gayle ,WI
691,242,240,124,124,0,0,124,3 (3ct 0st),0.516,2008,2019,V Kohli ,INDIA
692,92,92,124,120,4,120,0,5 (5ct 0st),1.347,1971,1984,RW Marsh ,AUS
693,445,441,123,123,0,0,123,3 (3ct 0st),0.278,1989,2011,ST Jayasuriya ,SL
694,227,225,120,120,0,0,120,4 (4ct 0st),0.5329999999999999,1987,2003,CL Hooper ,WI
695,299,296,120,120,0,0,120,3 (3ct 0st),0.405,1990,2007,BC Lara ,WI
696,85,83,117,105,12,105,0,4 (4ct 0st),1.409,2008,2017,L Ronchi ,AUS
697,94,94,117,108,9,108,0,5 (5ct 0st),1.244,2012,2017,MS Wade ,AUS
698,378,373,113,113,0,0,113,3 (3ct 0st),0.302,1991,2007,Inzamam-ul-Haq ,PAK
699,325,324,111,111,0,0,111,3 (3ct 0st),0.342,1986,2002,SR Waugh ,AUS
700,404,397,501,402,99,383,19,5 (4ct 1st),1.261,2000,2015,KC Sangakkara ,SL
701,287,286,472,417,55,417,0,6 (6ct 0st),1.65,1996,2008,AC Gilchrist ,AUS
702,350,345,444,321,123,321,0,6 (5ct 1st),1.286,2004,2019,MS Dhoni ,INDIA
703,295,291,425,403,22,402,1,6 (6ct 0st),1.46,1998,2011,MV Boucher ,SA
704,219,217,287,214,73,214,0,5 (5ct 0st),1.3219999999999998,1990,2004,Moin Khan ,PAK
705,260,257,277,262,15,227,35,5 (5ct 0st),1.077,2002,2016,BB McCullum ,NZ
706,168,168,233,194,39,194,0,4 (4ct 0st),1.386,1988,1997,IA Healy ,AUS
707,216,215,225,181,44,179,2,5 (5ct 0st),1.046,2006,2019,Mushfiqur Rahim ,BDESH
708,166,164,220,182,38,182,0,5 (5ct 0st),1.341,1992,2003,Rashid Latif ,PAK
709,448,443,218,218,0,0,218,4 (4ct 0st),0.492,1998,2015,DPMD Jayawardene ,SL
710,344,341,210,196,14,72,124,4 (4ct 0st),0.615,1996,2011,R Dravid ,INDIA
711,189,188,207,132,75,131,1,5 (4ct 1st),1.101,1990,2004,RS Kaluwitharana ,SL
712,169,168,204,183,21,183,0,4 (4ct 0st),1.214,1981,1991,PJL Dujon ,WI
713,142,138,202,171,31,171,0,6 (6ct 0st),1.463,2012,2019,JC Buttler ,ENG
714,147,145,189,160,29,160,0,6 (5ct 1st),1.3030000000000002,1996,2004,RD Jacobs ,WI
715,157,154,188,157,31,156,1,5 (4ct 1st),1.22,2002,2017,Kamran Akmal ,PAK
716,139,137,188,181,7,181,0,5 (5ct 0st),1.372,2005,2016,D Ramdin ,WI
717,228,223,181,176,5,93,83,5 (5ct 0st),0.8109999999999999,2005,2018,AB de Villiers ,SA
718,126,124,181,170,11,170,0,5 (5ct 0st),1.459,2001,2015,BJ Haddin ,AUS
719,170,169,174,159,15,148,11,6 (6ct 0st),1.029,1989,2003,AJ Stewart ,ENG
720,213,212,173,141,32,133,8,5 (5ct 0st),0.816,1992,2003,A Flower ,ZIM
721,115,111,166,158,8,158,0,6 (5ct 1st),1.495,2013,2019,Q de Kock ,SA
722,122,121,165,148,17,148,0,5 (5ct 0st),1.3630000000000002,1991,1998,DJ Richardson ,SA
723,375,372,160,160,0,0,160,3 (3ct 0st),0.43,1995,2012,RT Ponting ,AUS
724,334,332,156,156,0,0,156,4 (4ct 0st),0.469,1985,2000,M Azharuddin ,INDIA
725,140,139,154,110,44,110,0,5 (4ct 1st),1.107,1994,2000,NR Mongia ,INDIA
726,193,193,154,125,29,96,29,5 (5ct 0st),0.797,2004,2019,BRM Taylor ,ZIM
727,150,150,147,114,33,112,2,4 (4ct 0st),0.98,2001,2012,T Taibu ,ZIM
728,179,178,141,116,25,111,5,5 (3ct 2st),0.792,1992,2002,AC Parore ,NZ
729,116,114,140,116,24,116,0,6 (6ct 0st),1.228,2007,2019,Sarfaraz Ahmed ,PAK
730,463,456,140,140,0,0,140,4 (4ct 0st),0.307,1989,2012,SR Tendulkar ,INDIA
731,228,224,137,137,0,0,137,4 (4ct 0st),0.611,2006,2019,LRPL Taylor ,NZ
732,265,260,135,135,0,5,130,4 (4ct 0st),0.519,2000,2015,Younis Khan ,PAK
733,280,276,133,133,0,0,133,4 (4ct 0st),0.481,1994,2007,SP Fleming ,NZ
734,328,324,131,131,0,0,131,3 (3ct 0st),0.4039999999999999,1996,2014,JH Kallis ,SA
735,350,347,130,130,0,0,130,3 (3ct 0st),0.374,1993,2011,M Muralitharan ,SL
736,273,270,127,127,0,0,127,3 (3ct 0st),0.47,1979,1994,AR Border ,AUS
737,398,392,127,127,0,0,127,2 (2ct 0st),0.3229999999999999,1996,2015,Shahid Afridi ,PAK
738,126,126,126,91,35,91,0,5 (3ct 2st),1.0,1995,2006,Khaled Mashud ,BDESH
739,330,325,124,123,1,5,118,3 (3ct 0st),0.381,1999,2016,TM Dilshan ,SL
740,301,294,124,124,0,0,124,3 (3ct 0st),0.421,1999,2019,CH Gayle ,WI
741,242,240,124,124,0,0,124,3 (3ct 0st),0.516,2008,2019,V Kohli ,INDIA
742,92,92,124,120,4,120,0,5 (5ct 0st),1.347,1971,1984,RW Marsh ,AUS
743,445,441,123,123,0,0,123,3 (3ct 0st),0.278,1989,2011,ST Jayasuriya ,SL
744,227,225,120,120,0,0,120,4 (4ct 0st),0.5329999999999999,1987,2003,CL Hooper ,WI
745,299,296,120,120,0,0,120,3 (3ct 0st),0.405,1990,2007,BC Lara ,WI
746,85,83,117,105,12,105,0,4 (4ct 0st),1.409,2008,2017,L Ronchi ,AUS
747,94,94,117,108,9,108,0,5 (5ct 0st),1.244,2012,2017,MS Wade ,AUS
748,378,373,113,113,0,0,113,3 (3ct 0st),0.302,1991,2007,Inzamam-ul-Haq ,PAK
749,325,324,111,111,0,0,111,3 (3ct 0st),0.342,1986,2002,SR Waugh ,AUS
750,404,397,501,402,99,383,19,5 (4ct 1st),1.261,2000,2015,KC Sangakkara ,SL
751,287,286,472,417,55,417,0,6 (6ct 0st),1.65,1996,2008,AC Gilchrist ,AUS
752,350,345,444,321,123,321,0,6 (5ct 1st),1.286,2004,2019,MS Dhoni ,INDIA
753,295,291,425,403,22,402,1,6 (6ct 0st),1.46,1998,2011,MV Boucher ,SA
754,219,217,287,214,73,214,0,5 (5ct 0st),1.3219999999999998,1990,2004,Moin Khan ,PAK
755,260,257,277,262,15,227,35,5 (5ct 0st),1.077,2002,2016,BB McCullum ,NZ
756,168,168,233,194,39,194,0,4 (4ct 0st),1.386,1988,1997,IA Healy ,AUS
757,216,215,225,181,44,179,2,5 (5ct 0st),1.046,2006,2019,Mushfiqur Rahim ,BDESH
758,166,164,220,182,38,182,0,5 (5ct 0st),1.341,1992,2003,Rashid Latif ,PAK
759,448,443,218,218,0,0,218,4 (4ct 0st),0.492,1998,2015,DPMD Jayawardene ,SL
760,344,341,210,196,14,72,124,4 (4ct 0st),0.615,1996,2011,R Dravid ,INDIA
761,189,188,207,132,75,131,1,5 (4ct 1st),1.101,1990,2004,RS Kaluwitharana ,SL
762,169,168,204,183,21,183,0,4 (4ct 0st),1.214,1981,1991,PJL Dujon ,WI
763,142,138,202,171,31,171,0,6 (6ct 0st),1.463,2012,2019,JC Buttler ,ENG
764,147,145,189,160,29,160,0,6 (5ct 1st),1.3030000000000002,1996,2004,RD Jacobs ,WI
765,157,154,188,157,31,156,1,5 (4ct 1st),1.22,2002,2017,Kamran Akmal ,PAK
766,139,137,188,181,7,181,0,5 (5ct 0st),1.372,2005,2016,D Ramdin ,WI
767,228,223,181,176,5,93,83,5 (5ct 0st),0.8109999999999999,2005,2018,AB de Villiers ,SA
768,126,124,181,170,11,170,0,5 (5ct 0st),1.459,2001,2015,BJ Haddin ,AUS
769,170,169,174,159,15,148,11,6 (6ct 0st),1.029,1989,2003,AJ Stewart ,ENG
770,213,212,173,141,32,133,8,5 (5ct 0st),0.816,1992,2003,A Flower ,ZIM
771,115,111,166,158,8,158,0,6 (5ct 1st),1.495,2013,2019,Q de Kock ,SA
772,122,121,165,148,17,148,0,5 (5ct 0st),1.3630000000000002,1991,1998,DJ Richardson ,SA
773,375,372,160,160,0,0,160,3 (3ct 0st),0.43,1995,2012,RT Ponting ,AUS
774,334,332,156,156,0,0,156,4 (4ct 0st),0.469,1985,2000,M Azharuddin ,INDIA
775,140,139,154,110,44,110,0,5 (4ct 1st),1.107,1994,2000,NR Mongia ,INDIA
776,193,193,154,125,29,96,29,5 (5ct 0st),0.797,2004,2019,BRM Taylor ,ZIM
777,150,150,147,114,33,112,2,4 (4ct 0st),0.98,2001,2012,T Taibu ,ZIM
778,179,178,141,116,25,111,5,5 (3ct 2st),0.792,1992,2002,AC Parore ,NZ
779,116,114,140,116,24,116,0,6 (6ct 0st),1.228,2007,2019,Sarfaraz Ahmed ,PAK
780,463,456,140,140,0,0,140,4 (4ct 0st),0.307,1989,2012,SR Tendulkar ,INDIA
781,228,224,137,137,0,0,137,4 (4ct 0st),0.611,2006,2019,LRPL Taylor ,NZ
782,265,260,135,135,0,5,130,4 (4ct 0st),0.519,2000,2015,Younis Khan ,PAK
783,280,276,133,133,0,0,133,4 (4ct 0st),0.481,1994,2007,SP Fleming ,NZ
784,328,324,131,131,0,0,131,3 (3ct 0st),0.4039999999999999,1996,2014,JH Kallis ,SA
785,350,347,130,130,0,0,130,3 (3ct 0st),0.374,1993,2011,M Muralitharan ,SL
786,273,270,127,127,0,0,127,3 (3ct 0st),0.47,1979,1994,AR Border ,AUS
787,398,392,127,127,0,0,127,2 (2ct 0st),0.3229999999999999,1996,2015,Shahid Afridi ,PAK
788,126,126,126,91,35,91,0,5 (3ct 2st),1.0,1995,2006,Khaled Mashud ,BDESH
789,330,325,124,123,1,5,118,3 (3ct 0st),0.381,1999,2016,TM Dilshan ,SL
790,301,294,124,124,0,0,124,3 (3ct 0st),0.421,1999,2019,CH Gayle ,WI
791,242,240,124,124,0,0,124,3 (3ct 0st),0.516,2008,2019,V Kohli ,INDIA
792,92,92,124,120,4,120,0,5 (5ct 0st),1.347,1971,1984,RW Marsh ,AUS
793,445,441,123,123,0,0,123,3 (3ct 0st),0.278,1989,2011,ST Jayasuriya ,SL
794,227,225,120,120,0,0,120,4 (4ct 0st),0.5329999999999999,1987,2003,CL Hooper ,WI
795,299,296,120,120,0,0,120,3 (3ct 0st),0.405,1990,2007,BC Lara ,WI
796,85,83,117,105,12,105,0,4 (4ct 0st),1.409,2008,2017,L Ronchi ,AUS
797,94,94,117,108,9,108,0,5 (5ct 0st),1.244,2012,2017,MS Wade ,AUS
798,378,373,113,113,0,0,113,3 (3ct 0st),0.302,1991,2007,Inzamam-ul-Haq ,PAK
799,325,324,111,111,0,0,111,3 (3ct 0st),0.342,1986,2002,SR Waugh ,AUS
800,404,397,501,402,99,383,19,5 (4ct 1st),1.261,2000,2015,KC Sangakkara ,SL
801,287,286,472,417,55,417,0,6 (6ct 0st),1.65,1996,2008,AC Gilchrist ,AUS
802,350,345,444,321,123,321,0,6 (5ct 1st),1.286,2004,2019,MS Dhoni ,INDIA
803,295,291,425,403,22,402,1,6 (6ct 0st),1.46,1998,2011,MV Boucher ,SA
804,219,217,287,214,73,214,0,5 (5ct 0st),1.3219999999999998,1990,2004,Moin Khan ,PAK
805,260,257,277,262,15,227,35,5 (5ct 0st),1.077,2002,2016,BB McCullum ,NZ
806,168,168,233,194,39,194,0,4 (4ct 0st),1.386,1988,1997,IA Healy ,AUS
807,216,215,225,181,44,179,2,5 (5ct 0st),1.046,2006,2019,Mushfiqur Rahim ,BDESH
808,166,164,220,182,38,182,0,5 (5ct 0st),1.341,1992,2003,Rashid Latif ,PAK
809,448,443,218,218,0,0,218,4 (4ct 0st),0.492,1998,2015,DPMD Jayawardene ,SL
810,344,341,210,196,14,72,124,4 (4ct 0st),0.615,1996,2011,R Dravid ,INDIA
811,189,188,207,132,75,131,1,5 (4ct 1st),1.101,1990,2004,RS Kaluwitharana ,SL
812,169,168,204,183,21,183,0,4 (4ct 0st),1.214,1981,1991,PJL Dujon ,WI
813,142,138,202,171,31,171,0,6 (6ct 0st),1.463,2012,2019,JC Buttler ,ENG
814,147,145,189,160,29,160,0,6 (5ct 1st),1.3030000000000002,1996,2004,RD Jacobs ,WI
815,157,154,188,157,31,156,1,5 (4ct 1st),1.22,2002,2017,Kamran Akmal ,PAK
816,139,137,188,181,7,181,0,5 (5ct 0st),1.372,2005,2016,D Ramdin ,WI
817,228,223,181,176,5,93,83,5 (5ct 0st),0.8109999999999999,2005,2018,AB de Villiers ,SA
818,126,124,181,170,11,170,0,5 (5ct 0st),1.459,2001,2015,BJ Haddin ,AUS
819,170,169,174,159,15,148,11,6 (6ct 0st),1.029,1989,2003,AJ Stewart ,ENG
820,213,212,173,141,32,133,8,5 (5ct 0st),0.816,1992,2003,A Flower ,ZIM
821,115,111,166,158,8,158,0,6 (5ct 1st),1.495,2013,2019,Q de Kock ,SA
822,122,121,165,148,17,148,0,5 (5ct 0st),1.3630000000000002,1991,1998,DJ Richardson ,SA
823,375,372,160,160,0,0,160,3 (3ct 0st),0.43,1995,2012,RT Ponting ,AUS
824,334,332,156,156,0,0,156,4 (4ct 0st),0.469,1985,2000,M Azharuddin ,INDIA
825,140,139,154,110,44,110,0,5 (4ct 1st),1.107,1994,2000,NR Mongia ,INDIA
826,193,193,154,125,29,96,29,5 (5ct 0st),0.797,2004,2019,BRM Taylor ,ZIM
827,150,150,147,114,33,112,2,4 (4ct 0st),0.98,2001,2012,T Taibu ,ZIM
828,179,178,141,116,25,111,5,5 (3ct 2st),0.792,1992,2002,AC Parore ,NZ
829,116,114,140,116,24,116,0,6 (6ct 0st),1.228,2007,2019,Sarfaraz Ahmed ,PAK
830,463,456,140,140,0,0,140,4 (4ct 0st),0.307,1989,2012,SR Tendulkar ,INDIA
831,228,224,137,137,0,0,137,4 (4ct 0st),0.611,2006,2019,LRPL Taylor ,NZ
832,265,260,135,135,0,5,130,4 (4ct 0st),0.519,2000,2015,Younis Khan ,PAK
833,280,276,133,133,0,0,133,4 (4ct 0st),0.481,1994,2007,SP Fleming ,NZ
834,328,324,131,131,0,0,131,3 (3ct 0st),0.4039999999999999,1996,2014,JH Kallis ,SA
835,350,347,130,130,0,0,130,3 (3ct 0st),0.374,1993,2011,M Muralitharan ,SL
836,273,270,127,127,0,0,127,3 (3ct 0st),0.47,1979,1994,AR Border ,AUS
837,398,392,127,127,0,0,127,2 (2ct 0st),0.3229999999999999,1996,2015,Shahid Afridi ,PAK
838,126,126,126,91,35,91,0,5 (3ct 2st),1.0,1995,2006,Khaled Mashud ,BDESH
839,330,325,124,123,1,5,118,3 (3ct 0st),0.381,1999,2016,TM Dilshan ,SL
840,301,294,124,124,0,0,124,3 (3ct 0st),0.421,1999,2019,CH Gayle ,WI
841,242,240,124,124,0,0,124,3 (3ct 0st),0.516,2008,2019,V Kohli ,INDIA
842,92,92,124,120,4,120,0,5 (5ct 0st),1.347,1971,1984,RW Marsh ,AUS
843,445,441,123,123,0,0,123,3 (3ct 0st),0.278,1989,2011,ST Jayasuriya ,SL
844,227,225,120,120,0,0,120,4 (4ct 0st),0.5329999999999999,1987,2003,CL Hooper ,WI
845,299,296,120,120,0,0,120,3 (3ct 0st),0.405,1990,2007,BC Lara ,WI
846,85,83,117,105,12,105,0,4 (4ct 0st),1.409,2008,2017,L Ronchi ,AUS
847,94,94,117,108,9,108,0,5 (5ct 0st),1.244,2012,2017,MS Wade ,AUS
848,378,373,113,113,0,0,113,3 (3ct 0st),0.302,1991,2007,Inzamam-ul-Haq ,PAK
849,325,324,111,111,0,0,111,3 (3ct 0st),0.342,1986,2002,SR Waugh ,AUS
850,404,397,501,402,99,383,19,5 (4ct 1st),1.261,2000,2015,KC Sangakkara ,SL
851,287,286,472,417,55,417,0,6 (6ct 0st),1.65,1996,2008,AC Gilchrist ,AUS
852,350,345,444,321,123,321,0,6 (5ct 1st),1.286,2004,2019,MS Dhoni ,INDIA
853,295,291,425,403,22,402,1,6 (6ct 0st),1.46,1998,2011,MV Boucher ,SA
854,219,217,287,214,73,214,0,5 (5ct 0st),1.3219999999999998,1990,2004,Moin Khan ,PAK
855,260,257,277,262,15,227,35,5 (5ct 0st),1.077,2002,2016,BB McCullum ,NZ
856,168,168,233,194,39,194,0,4 (4ct 0st),1.386,1988,1997,IA Healy ,AUS
857,216,215,225,181,44,179,2,5 (5ct 0st),1.046,2006,2019,Mushfiqur Rahim ,BDESH
858,166,164,220,182,38,182,0,5 (5ct 0st),1.341,1992,2003,Rashid Latif ,PAK
859,448,443,218,218,0,0,218,4 (4ct 0st),0.492,1998,2015,DPMD Jayawardene ,SL
860,344,341,210,196,14,72,124,4 (4ct 0st),0.615,1996,2011,R Dravid ,INDIA
861,189,188,207,132,75,131,1,5 (4ct 1st),1.101,1990,2004,RS Kaluwitharana ,SL
862,169,168,204,183,21,183,0,4 (4ct 0st),1.214,1981,1991,PJL Dujon ,WI
863,142,138,202,171,31,171,0,6 (6ct 0st),1.463,2012,2019,JC Buttler ,ENG
864,147,145,189,160,29,160,0,6 (5ct 1st),1.3030000000000002,1996,2004,RD Jacobs ,WI
865,157,154,188,157,31,156,1,5 (4ct 1st),1.22,2002,2017,Kamran Akmal ,PAK
866,139,137,188,181,7,181,0,5 (5ct 0st),1.372,2005,2016,D Ramdin ,WI
867,228,223,181,176,5,93,83,5 (5ct 0st),0.8109999999999999,2005,2018,AB de Villiers ,SA
868,126,124,181,170,11,170,0,5 (5ct 0st),1.459,2001,2015,BJ Haddin ,AUS
869,170,169,174,159,15,148,11,6 (6ct 0st),1.029,1989,2003,AJ Stewart ,ENG
870,213,212,173,141,32,133,8,5 (5ct 0st),0.816,1992,2003,A Flower ,ZIM
871,115,111,166,158,8,158,0,6 (5ct 1st),1.495,2013,2019,Q de Kock ,SA
872,122,121,165,148,17,148,0,5 (5ct 0st),1.3630000000000002,1991,1998,DJ Richardson ,SA
873,375,372,160,160,0,0,160,3 (3ct 0st),0.43,1995,2012,RT Ponting ,AUS
874,334,332,156,156,0,0,156,4 (4ct 0st),0.469,1985,2000,M Azharuddin ,INDIA
875,140,139,154,110,44,110,0,5 (4ct 1st),1.107,1994,2000,NR Mongia ,INDIA
876,193,193,154,125,29,96,29,5 (5ct 0st),0.797,2004,2019,BRM Taylor ,ZIM
877,150,150,147,114,33,112,2,4 (4ct 0st),0.98,2001,2012,T Taibu ,ZIM
878,179,178,141,116,25,111,5,5 (3ct 2st),0.792,1992,2002,AC Parore ,NZ
879,116,114,140,116,24,116,0,6 (6ct 0st),1.228,2007,2019,Sarfaraz Ahmed ,PAK
880,463,456,140,140,0,0,140,4 (4ct 0st),0.307,1989,2012,SR Tendulkar ,INDIA
881,228,224,137,137,0,0,137,4 (4ct 0st),0.611,2006,2019,LRPL Taylor ,NZ
882,265,260,135,135,0,5,130,4 (4ct 0st),0.519,2000,2015,Younis Khan ,PAK
883,280,276,133,133,0,0,133,4 (4ct 0st),0.481,1994,2007,SP Fleming ,NZ
884,328,324,131,131,0,0,131,3 (3ct 0st),0.4039999999999999,1996,2014,JH Kallis ,SA
885,350,347,130,130,0,0,130,3 (3ct 0st),0.374,1993,2011,M Muralitharan ,SL
886,273,270,127,127,0,0,127,3 (3ct 0st),0.47,1979,1994,AR Border ,AUS
887,398,392,127,127,0,0,127,2 (2ct 0st),0.3229999999999999,1996,2015,Shahid Afridi ,PAK
888,126,126,126,91,35,91,0,5 (3ct 2st),1.0,1995,2006,Khaled Mashud ,BDESH
889,330,325,124,123,1,5,118,3 (3ct 0st),0.381,1999,2016,TM Dilshan ,SL
890,301,294,124,124,0,0,124,3 (3ct 0st),0.421,1999,2019,CH Gayle ,WI
891,242,240,124,124,0,0,124,3 (3ct 0st),0.516,2008,2019,V Kohli ,INDIA
892,92,92,124,120,4,120,0,5 (5ct 0st),1.347,1971,1984,RW Marsh ,AUS
893,445,441,123,123,0,0,123,3 (3ct 0st),0.278,1989,2011,ST Jayasuriya ,SL
894,227,225,120,120,0,0,120,4 (4ct 0st),0.5329999999999999,1987,2003,CL Hooper ,WI
895,299,296,120,120,0,0,120,3 (3ct 0st),0.405,1990,2007,BC Lara ,WI
896,85,83,117,105,12,105,0,4 (4ct 0st),1.409,2008,2017,L Ronchi ,AUS
897,94,94,117,108,9,108,0,5 (5ct 0st),1.244,2012,2017,MS Wade ,AUS
898,378,373,113,113,0,0,113,3 (3ct 0st),0.302,1991,2007,Inzamam-ul-Haq ,PAK
899,325,324,111,111,0,0,111,3 (3ct 0st),0.342,1986,2002,SR Waugh ,AUS
900,404,397,501,402,99,383,19,5 (4ct 1st),1.261,2000,2015,KC Sangakkara ,SL
901,287,286,472,417,55,417,0,6 (6ct 0st),1.65,1996,2008,AC Gilchrist ,AUS
902,350,345,444,321,123,321,0,6 (5ct 1st),1.286,2004,2019,MS Dhoni ,INDIA
903,295,291,425,403,22,402,1,6 (6ct 0st),1.46,1998,2011,MV Boucher ,SA
904,219,217,287,214,73,214,0,5 (5ct 0st),1.3219999999999998,1990,2004,Moin Khan ,PAK
905,260,257,277,262,15,227,35,5 (5ct 0st),1.077,2002,2016,BB McCullum ,NZ
906,168,168,233,194,39,194,0,4 (4ct 0st),1.386,1988,1997,IA Healy ,AUS
907,216,215,225,181,44,179,2,5 (5ct 0st),1.046,2006,2019,Mushfiqur Rahim ,BDESH
908,166,164,220,182,38,182,0,5 (5ct 0st),1.341,1992,2003,Rashid Latif ,PAK
909,448,443,218,218,0,0,218,4 (4ct 0st),0.492,1998,2015,DPMD Jayawardene ,SL
910,344,341,210,196,14,72,124,4 (4ct 0st),0.615,1996,2011,R Dravid ,INDIA
911,189,188,207,132,75,131,1,5 (4ct 1st),1.101,1990,2004,RS Kaluwitharana ,SL
912,169,168,204,183,21,183,0,4 (4ct 0st),1.214,1981,1991,PJL Dujon ,WI
913,142,138,202,171,31,171,0,6 (6ct 0st),1.463,2012,2019,JC Buttler ,ENG
914,147,145,189,160,29,160,0,6 (5ct 1st),1.3030000000000002,1996,2004,RD Jacobs ,WI
915,157,154,188,157,31,156,1,5 (4ct 1st),1.22,2002,2017,Kamran Akmal ,PAK
916,139,137,188,181,7,181,0,5 (5ct 0st),1.372,2005,2016,D Ramdin ,WI
917,228,223,181,176,5,93,83,5 (5ct 0st),0.8109999999999999,2005,2018,AB de Villiers ,SA
918,126,124,181,170,11,170,0,5 (5ct 0st),1.459,2001,2015,BJ Haddin ,AUS
919,170,169,174,159,15,148,11,6 (6ct 0st),1.029,1989,2003,AJ Stewart ,ENG
920,213,212,173,141,32,133,8,5 (5ct 0st),0.816,1992,2003,A Flower ,ZIM
921,115,111,166,158,8,158,0,6 (5ct 1st),1.495,2013,2019,Q de Kock ,SA
922,122,121,165,148,17,148,0,5 (5ct 0st),1.3630000000000002,1991,1998,DJ Richardson ,SA
923,375,372,160,160,0,0,160,3 (3ct 0st),0.43,1995,2012,RT Ponting ,AUS
924,334,332,156,156,0,0,156,4 (4ct 0st),0.469,1985,2000,M Azharuddin ,INDIA
925,140,139,154,110,44,110,0,5 (4ct 1st),1.107,1994,2000,NR Mongia ,INDIA
926,193,193,154,125,29,96,29,5 (5ct 0st),0.797,2004,2019,BRM Taylor ,ZIM
927,150,150,147,114,33,112,2,4 (4ct 0st),0.98,2001,2012,T Taibu ,ZIM
928,179,178,141,116,25,111,5,5 (3ct 2st),0.792,1992,2002,AC Parore ,NZ
929,116,114,140,116,24,116,0,6 (6ct 0st),1.228,2007,2019,Sarfaraz Ahmed ,PAK
930,463,456,140,140,0,0,140,4 (4ct 0st),0.307,1989,2012,SR Tendulkar ,INDIA
931,228,224,137,137,0,0,137,4 (4ct 0st),0.611,2006,2019,LRPL Taylor ,NZ
932,265,260,135,135,0,5,130,4 (4ct 0st),0.519,2000,2015,Younis Khan ,PAK
933,280,276,133,133,0,0,133,4 (4ct 0st),0.481,1994,2007,SP Fleming ,NZ
934,328,324,131,131,0,0,131,3 (3ct 0st),0.4039999999999999,1996,2014,JH Kallis ,SA
935,350,347,130,130,0,0,130,3 (3ct 0st),0.374,1993,2011,M Muralitharan ,SL
936,273,270,127,127,0,0,127,3 (3ct 0st),0.47,1979,1994,AR Border ,AUS
937,398,392,127,127,0,0,127,2 (2ct 0st),0.3229999999999999,1996,2015,Shahid Afridi ,PAK
938,126,126,126,91,35,91,0,5 (3ct 2st),1.0,1995,2006,Khaled Mashud ,BDESH
939,330,325,124,123,1,5,118,3 (3ct 0st),0.381,1999,2016,TM Dilshan ,SL
940,301,294,124,124,0,0,124,3 (3ct 0st),0.421,1999,2019,CH Gayle ,WI
941,242,240,124,124,0,0,124,3 (3ct 0st),0.516,2008,2019,V Kohli ,INDIA
942,92,92,124,120,4,120,0,5 (5ct 0st),1.347,1971,1984,RW Marsh ,AUS
943,445,441,123,123,0,0,123,3 (3ct 0st),0.278,1989,2011,ST Jayasuriya ,SL
944,227,225,120,120,0,0,120,4 (4ct 0st),0.5329999999999999,1987,2003,CL Hooper ,WI
945,299,296,120,120,0,0,120,3 (3ct 0st),0.405,1990,2007,BC Lara ,WI
946,85,83,117,105,12,105,0,4 (4ct 0st),1.409,2008,2017,L Ronchi ,AUS
947,94,94,117,108,9,108,0,5 (5ct 0st),1.244,2012,2017,MS Wade ,AUS
948,378,373,113,113,0,0,113,3 (3ct 0st),0.302,1991,2007,Inzamam-ul-Haq ,PAK
949,325,324,111,111,0,0,111,3 (3ct 0st),0.342,1986,2002,SR Waugh ,AUS
950,404,397,501,402,99,383,19,5 (4ct 1st),1.261,2000,2015,KC Sangakkara ,SL
951,287,286,472,417,55,417,0,6 (6ct 0st),1.65,1996,2008,AC Gilchrist ,AUS
952,350,345,444,321,123,321,0,6 (5ct 1st),1.286,2004,2019,MS Dhoni ,INDIA
953,295,291,425,403,22,402,1,6 (6ct 0st),1.46,1998,2011,MV Boucher ,SA
954,219,217,287,214,73,214,0,5 (5ct 0st),1.3219999999999998,1990,2004,Moin Khan ,PAK
955,260,257,277,262,15,227,35,5 (5ct 0st),1.077,2002,2016,BB McCullum ,NZ
956,168,168,233,194,39,194,0,4 (4ct 0st),1.386,1988,1997,IA Healy ,AUS
957,216,215,225,181,44,179,2,5 (5ct 0st),1.046,2006,2019,Mushfiqur Rahim ,BDESH
958,166,164,220,182,38,182,0,5 (5ct 0st),1.341,1992,2003,Rashid Latif ,PAK
959,448,443,218,218,0,0,218,4 (4ct 0st),0.492,1998,2015,DPMD Jayawardene ,SL
960,344,341,210,196,14,72,124,4 (4ct 0st),0.615,1996,2011,R Dravid ,INDIA
961,189,188,207,132,75,131,1,5 (4ct 1st),1.101,1990,2004,RS Kaluwitharana ,SL
962,169,168,204,183,21,183,0,4 (4ct 0st),1.214,1981,1991,PJL Dujon ,WI
963,142,138,202,171,31,171,0,6 (6ct 0st),1.463,2012,2019,JC Buttler ,ENG
964,147,145,189,160,29,160,0,6 (5ct 1st),1.3030000000000002,1996,2004,RD Jacobs ,WI
965,157,154,188,157,31,156,1,5 (4ct 1st),1.22,2002,2017,Kamran Akmal ,PAK
966,139,137,188,181,7,181,0,5 (5ct 0st),1.372,2005,2016,D Ramdin ,WI
967,228,223,181,176,5,93,83,5 (5ct 0st),0.8109999999999999,2005,2018,AB de Villiers ,SA
968,126,124,181,170,11,170,0,5 (5ct 0st),1.459,2001,2015,BJ Haddin ,AUS
969,170,169,174,159,15,148,11,6 (6ct 0st),1.029,1989,2003,AJ Stewart ,ENG
970,213,212,173,141,32,133,8,5 (5ct 0st),0.816,1992,2003,A Flower ,ZIM
971,115,111,166,158,8,158,0,6 (5ct 1st),1.495,2013,2019,Q de Kock ,SA
972,122,121,165,148,17,148,0,5 (5ct 0st),1.3630000000000002,1991,1998,DJ Richardson ,SA
973,375,372,160,160,0,0,160,3 (3ct 0st),0.43,1995,2012,RT Ponting ,AUS
974,334,332,156,156,0,0,156,4 (4ct 0st),0.469,1985,2000,M Azharuddin ,INDIA
975,140,139,154,110,44,110,0,5 (4ct 1st),1.107,1994,2000,NR Mongia ,INDIA
976,193,193,154,125,29,96,29,5 (5ct 0st),0.797,2004,2019,BRM Taylor ,ZIM
977,150,150,147,114,33,112,2,4 (4ct 0st),0.98,2001,2012,T Taibu ,ZIM
978,179,178,141,116,25,111,5,5 (3ct 2st),0.792,1992,2002,AC Parore ,NZ
979,116,114,140,116,24,116,0,6 (6ct 0st),1.228,2007,2019,Sarfaraz Ahmed ,PAK
980,463,456,140,140,0,0,140,4 (4ct 0st),0.307,1989,2012,SR Tendulkar ,INDIA
981,228,224,137,137,0,0,137,4 (4ct 0st),0.611,2006,2019,LRPL Taylor ,NZ
982,265,260,135,135,0,5,130,4 (4ct 0st),0.519,2000,2015,Younis Khan ,PAK
983,280,276,133,133,0,0,133,4 (4ct 0st),0.481,1994,2007,SP Fleming ,NZ
984,328,324,131,131,0,0,131,3 (3ct 0st),0.4039999999999999,1996,2014,JH Kallis ,SA
985,350,347,130,130,0,0,130,3 (3ct 0st),0.374,1993,2011,M Muralitharan ,SL
986,273,270,127,127,0,0,127,3 (3ct 0st),0.47,1979,1994,AR Border ,AUS
987,398,392,127,127,0,0,127,2 (2ct 0st),0.3229999999999999,1996,2015,Shahid Afridi ,PAK
988,126,126,126,91,35,91,0,5 (3ct 2st),1.0,1995,2006,Khaled Mashud ,BDESH
989,330,325,124,123,1,5,118,3 (3ct 0st),0.381,1999,2016,TM Dilshan ,SL
990,301,294,124,124,0,0,124,3 (3ct 0st),0.421,1999,2019,CH Gayle ,WI
991,242,240,124,124,0,0,124,3 (3ct 0st),0.516,2008,2019,V Kohli ,INDIA
992,92,92,124,120,4,120,0,5 (5ct 0st),1.347,1971,1984,RW Marsh ,AUS
993,445,441,123,123,0,0,123,3 (3ct 0st),0.278,1989,2011,ST Jayasuriya ,SL
994,227,225,120,120,0,0,120,4 (4ct 0st),0.5329999999999999,1987,2003,CL Hooper ,WI
995,299,296,120,120,0,0,120,3 (3ct 0st),0.405,1990,2007,BC Lara ,WI
996,85,83,117,105,12,105,0,4 (4ct 0st),1.409,2008,2017,L Ronchi ,AUS
997,94,94,117,108,9,108,0,5 (5ct 0st),1.244,2012,2017,MS Wade ,AUS
998,378,373,113,113,0,0,113,3 (3ct 0st),0.302,1991,2007,Inzamam-ul-Haq ,PAK
999,325,324,111,111,0,0,111,3 (3ct 0st),0.342,1986,2002,SR Waugh ,AUS
1000,404,397,501,402,99,383,19,5 (4ct 1st),1.261,2000,2015,KC Sangakkara ,SL
1001,287,286,472,417,55,417,0,6 (6ct 0st),1.65,1996,2008,AC Gilchrist ,AUS
1002,350,345,444,321,123,321,0,6 (5ct 1st),1.286,2004,2019,MS Dhoni ,INDIA
1003,295,291,425,403,22,402,1,6 (6ct 0st),1.46,1998,2011,MV Boucher ,SA
1004,219,217,287,214,73,214,0,5 (5ct 0st),1.3219999999999998,1990,2004,Moin Khan ,PAK
1005,260,257,277,262,15,227,35,5 (5ct 0st),1.077,2002,2016,BB McCullum ,NZ
1006,168,168,233,194,39,194,0,4 (4ct 0st),1.386,1988,1997,IA Healy ,AUS
1007,216,215,225,181,44,179,2,5 (5ct 0st),1.046,2006,2019,Mushfiqur Rahim ,BDESH
1008,166,164,220,182,38,182,0,5 (5ct 0st),1.341,1992,2003,Rashid Latif ,PAK
1009,448,443,218,218,0,0,218,4 (4ct 0st),0.492,1998,2015,DPMD Jayawardene ,SL
1010,344,341,210,196,14,72,124,4 (4ct 0st),0.615,1996,2011,R Dravid ,INDIA
1011,189,188,207,132,75,131,1,5 (4ct 1st),1.101,1990,2004,RS Kaluwitharana ,SL
1012,169,168,204,183,21,183,0,4 (4ct 0st),1.214,1981,1991,PJL Dujon ,WI
1013,142,138,202,171,31,171,0,6 (6ct 0st),1.463,2012,2019,JC Buttler ,ENG
1014,147,145,189,160,29,160,0,6 (5ct 1st),1.3030000000000002,1996,2004,RD Jacobs ,WI
1015,157,154,188,157,31,156,1,5 (4ct 1st),1.22,2002,2017,Kamran Akmal ,PAK
1016,139,137,188,181,7,181,0,5 (5ct 0st),1.372,2005,2016,D Ramdin ,WI
1017,228,223,181,176,5,93,83,5 (5ct 0st),0.8109999999999999,2005,2018,AB de Villiers ,SA
1018,126,124,181,170,11,170,0,5 (5ct 0st),1.459,2001,2015,BJ Haddin ,AUS
1019,170,169,174,159,15,148,11,6 (6ct 0st),1.029,1989,2003,AJ Stewart ,ENG
1020,213,212,173,141,32,133,8,5 (5ct 0st),0.816,1992,2003,A Flower ,ZIM
1021,115,111,166,158,8,158,0,6 (5ct 1st),1.495,2013,2019,Q de Kock ,SA
1022,122,121,165,148,17,148,0,5 (5ct 0st),1.3630000000000002,1991,1998,DJ Richardson ,SA
1023,375,372,160,160,0,0,160,3 (3ct 0st),0.43,1995,2012,RT Ponting ,AUS
1024,334,332,156,156,0,0,156,4 (4ct 0st),0.469,1985,2000,M Azharuddin ,INDIA
1025,140,139,154,110,44,110,0,5 (4ct 1st),1.107,1994,2000,NR Mongia ,INDIA
1026,193,193,154,125,29,96,29,5 (5ct 0st),0.797,2004,2019,BRM Taylor ,ZIM
1027,150,150,147,114,33,112,2,4 (4ct 0st),0.98,2001,2012,T Taibu ,ZIM
1028,179,178,141,116,25,111,5,5 (3ct 2st),0.792,1992,2002,AC Parore ,NZ
1029,116,114,140,116,24,116,0,6 (6ct 0st),1.228,2007,2019,Sarfaraz Ahmed ,PAK
1030,463,456,140,140,0,0,140,4 (4ct 0st),0.307,1989,2012,SR Tendulkar ,INDIA
1031,228,224,137,137,0,0,137,4 (4ct 0st),0.611,2006,2019,LRPL Taylor ,NZ
1032,265,260,135,135,0,5,130,4 (4ct 0st),0.519,2000,2015,Younis Khan ,PAK
1033,280,276,133,133,0,0,133,4 (4ct 0st),0.481,1994,2007,SP Fleming ,NZ
1034,328,324,131,131,0,0,131,3 (3ct 0st),0.4039999999999999,1996,2014,JH Kallis ,SA
1035,350,347,130,130,0,0,130,3 (3ct 0st),0.374,1993,2011,M Muralitharan ,SL
1036,273,270,127,127,0,0,127,3 (3ct 0st),0.47,1979,1994,AR Border ,AUS
1037,398,392,127,127,0,0,127,2 (2ct 0st),0.3229999999999999,1996,2015,Shahid Afridi ,PAK
1038,126,126,126,91,35,91,0,5 (3ct 2st),1.0,1995,2006,Khaled Mashud ,BDESH
1039,330,325,124,123,1,5,118,3 (3ct 0st),0.381,1999,2016,TM Dilshan ,SL
1040,301,294,124,124,0,0,124,3 (3ct 0st),0.421,1999,2019,CH Gayle ,WI
1041,242,240,124,124,0,0,124,3 (3ct 0st),0.516,2008,2019,V Kohli ,INDIA
1042,92,92,124,120,4,120,0,5 (5ct 0st),1.347,1971,1984,RW Marsh ,AUS
1043,445,441,123,123,0,0,123,3 (3ct 0st),0.278,1989,2011,ST Jayasuriya ,SL
1044,227,225,120,120,0,0,120,4 (4ct 0st),0.5329999999999999,1987,2003,CL Hooper ,WI
1045,299,296,120,120,0,0,120,3 (3ct 0st),0.405,1990,2007,BC Lara ,WI
1046,85,83,117,105,12,105,0,4 (4ct 0st),1.409,2008,2017,L Ronchi ,AUS
1047,94,94,117,108,9,108,0,5 (5ct 0st),1.244,2012,2017,MS Wade ,AUS
1048,378,373,113,113,0,0,113,3 (3ct 0st),0.302,1991,2007,Inzamam-ul-Haq ,PAK
1049,325,324,111,111,0,0,111,3 (3ct 0st),0.342,1986,2002,SR Waugh ,AUS
1050,404,397,501,402,99,383,19,5 (4ct 1st),1.261,2000,2015,KC Sangakkara ,SL
1051,287,286,472,417,55,417,0,6 (6ct 0st),1.65,1996,2008,AC Gilchrist ,AUS
1052,350,345,444,321,123,321,0,6 (5ct 1st),1.286,2004,2019,MS Dhoni ,INDIA
1053,295,291,425,403,22,402,1,6 (6ct 0st),1.46,1998,2011,MV Boucher ,SA
1054,219,217,287,214,73,214,0,5 (5ct 0st),1.3219999999999998,1990,2004,Moin Khan ,PAK
1055,260,257,277,262,15,227,35,5 (5ct 0st),1.077,2002,2016,BB McCullum ,NZ
1056,168,168,233,194,39,194,0,4 (4ct 0st),1.386,1988,1997,IA Healy ,AUS
1057,216,215,225,181,44,179,2,5 (5ct 0st),1.046,2006,2019,Mushfiqur Rahim ,BDESH
1058,166,164,220,182,38,182,0,5 (5ct 0st),1.341,1992,2003,Rashid Latif ,PAK
1059,448,443,218,218,0,0,218,4 (4ct 0st),0.492,1998,2015,DPMD Jayawardene ,SL
1060,344,341,210,196,14,72,124,4 (4ct 0st),0.615,1996,2011,R Dravid ,INDIA
1061,189,188,207,132,75,131,1,5 (4ct 1st),1.101,1990,2004,RS Kaluwitharana ,SL
1062,169,168,204,183,21,183,0,4 (4ct 0st),1.214,1981,1991,PJL Dujon ,WI
1063,142,138,202,171,31,171,0,6 (6ct 0st),1.463,2012,2019,JC Buttler ,ENG
1064,147,145,189,160,29,160,0,6 (5ct 1st),1.3030000000000002,1996,2004,RD Jacobs ,WI
1065,157,154,188,157,31,156,1,5 (4ct 1st),1.22,2002,2017,Kamran Akmal ,PAK
1066,139,137,188,181,7,181,0,5 (5ct 0st),1.372,2005,2016,D Ramdin ,WI
1067,228,223,181,176,5,93,83,5 (5ct 0st),0.8109999999999999,2005,2018,AB de Villiers ,SA
1068,126,124,181,170,11,170,0,5 (5ct 0st),1.459,2001,2015,BJ Haddin ,AUS
1069,170,169,174,159,15,148,11,6 (6ct 0st),1.029,1989,2003,AJ Stewart ,ENG
1070,213,212,173,141,32,133,8,5 (5ct 0st),0.816,1992,2003,A Flower ,ZIM
1071,115,111,166,158,8,158,0,6 (5ct 1st),1.495,2013,2019,Q de Kock ,SA
1072,122,121,165,148,17,148,0,5 (5ct 0st),1.3630000000000002,1991,1998,DJ Richardson ,SA
1073,375,372,160,160,0,0,160,3 (3ct 0st),0.43,1995,2012,RT Ponting ,AUS
1074,334,332,156,156,0,0,156,4 (4ct 0st),0.469,1985,2000,M Azharuddin ,INDIA
1075,140,139,154,110,44,110,0,5 (4ct 1st),1.107,1994,2000,NR Mongia ,INDIA
1076,193,193,154,125,29,96,29,5 (5ct 0st),0.797,2004,2019,BRM Taylor ,ZIM
1077,150,150,147,114,33,112,2,4 (4ct 0st),0.98,2001,2012,T Taibu ,ZIM
1078,179,178,141,116,25,111,5,5 (3ct 2st),0.792,1992,2002,AC Parore ,NZ
1079,116,114,140,116,24,116,0,6 (6ct 0st),1.228,2007,2019,Sarfaraz Ahmed ,PAK
1080,463,456,140,140,0,0,140,4 (4ct 0st),0.307,1989,2012,SR Tendulkar ,INDIA
1081,228,224,137,137,0,0,137,4 (4ct 0st),0.611,2006,2019,LRPL Taylor ,NZ
1082,265,260,135,135,0,5,130,4 (4ct 0st),0.519,2000,2015,Younis Khan ,PAK
1083,280,276,133,133,0,0,133,4 (4ct 0st),0.481,1994,2007,SP Fleming ,NZ
1084,328,324,131,131,0,0,131,3 (3ct 0st),0.4039999999999999,1996,2014,JH Kallis ,SA
1085,350,347,130,130,0,0,130,3 (3ct 0st),0.374,1993,2011,M Muralitharan ,SL
1086,273,270,127,127,0,0,127,3 (3ct 0st),0.47,1979,1994,AR Border ,AUS
1087,398,392,127,127,0,0,127,2 (2ct 0st),0.3229999999999999,1996,2015,Shahid Afridi ,PAK
1088,126,126,126,91,35,91,0,5 (3ct 2st),1.0,1995,2006,Khaled Mashud ,BDESH
1089,330,325,124,123,1,5,118,3 (3ct 0st),0.381,1999,2016,TM Dilshan ,SL
1090,301,294,124,124,0,0,124,3 (3ct 0st),0.421,1999,2019,CH Gayle ,WI
1091,242,240,124,124,0,0,124,3 (3ct 0st),0.516,2008,2019,V Kohli ,INDIA
1092,92,92,124,120,4,120,0,5 (5ct 0st),1.347,1971,1984,RW Marsh ,AUS
1093,445,441,123,123,0,0,123,3 (3ct 0st),0.278,1989,2011,ST Jayasuriya ,SL
1094,227,225,120,120,0,0,120,4 (4ct 0st),0.5329999999999999,1987,2003,CL Hooper ,WI
1095,299,296,120,120,0,0,120,3 (3ct 0st),0.405,1990,2007,BC Lara ,WI
1096,85,83,117,105,12,105,0,4 (4ct 0st),1.409,2008,2017,L Ronchi ,AUS
1097,94,94,117,108,9,108,0,5 (5ct 0st),1.244,2012,2017,MS Wade ,AUS
1098,378,373,113,113,0,0,113,3 (3ct 0st),0.302,1991,2007,Inzamam-ul-Haq ,PAK
1099,325,324,111,111,0,0,111,3 (3ct 0st),0.342,1986,2002,SR Waugh ,AUS
1100,404,397,501,402,99,383,19,5 (4ct 1st),1.261,2000,2015,KC Sangakkara ,SL
1101,287,286,472,417,55,417,0,6 (6ct 0st),1.65,1996,2008,AC Gilchrist ,AUS
1102,350,345,444,321,123,321,0,6 (5ct 1st),1.286,2004,2019,MS Dhoni ,INDIA
1103,295,291,425,403,22,402,1,6 (6ct 0st),1.46,1998,2011,MV Boucher ,SA
1104,219,217,287,214,73,214,0,5 (5ct 0st),1.3219999999999998,1990,2004,Moin Khan ,PAK
1105,260,257,277,262,15,227,35,5 (5ct 0st),1.077,2002,2016,BB McCullum ,NZ
1106,168,168,233,194,39,194,0,4 (4ct 0st),1.386,1988,1997,IA Healy ,AUS
1107,216,215,225,181,44,179,2,5 (5ct 0st),1.046,2006,2019,Mushfiqur Rahim ,BDESH
1108,166,164,220,182,38,182,0,5 (5ct 0st),1.341,1992,2003,Rashid Latif ,PAK
1109,448,443,218,218,0,0,218,4 (4ct 0st),0.492,1998,2015,DPMD Jayawardene ,SL
1110,344,341,210,196,14,72,124,4 (4ct 0st),0.615,1996,2011,R Dravid ,INDIA
1111,189,188,207,132,75,131,1,5 (4ct 1st),1.101,1990,2004,RS Kaluwitharana ,SL
1112,169,168,204,183,21,183,0,4 (4ct 0st),1.214,1981,1991,PJL Dujon ,WI
1113,142,138,202,171,31,171,0,6 (6ct 0st),1.463,2012,2019,JC Buttler ,ENG
1114,147,145,189,160,29,160,0,6 (5ct 1st),1.3030000000000002,1996,2004,RD Jacobs ,WI
1115,157,154,188,157,31,156,1,5 (4ct 1st),1.22,2002,2017,Kamran Akmal ,PAK
1116,139,137,188,181,7,181,0,5 (5ct 0st),1.372,2005,2016,D Ramdin ,WI
1117,228,223,181,176,5,93,83,5 (5ct 0st),0.8109999999999999,2005,2018,AB de Villiers ,SA
1118,126,124,181,170,11,170,0,5 (5ct 0st),1.459,2001,2015,BJ Haddin ,AUS
1119,170,169,174,159,15,148,11,6 (6ct 0st),1.029,1989,2003,AJ Stewart ,ENG
1120,213,212,173,141,32,133,8,5 (5ct 0st),0.816,1992,2003,A Flower ,ZIM
1121,115,111,166,158,8,158,0,6 (5ct 1st),1.495,2013,2019,Q de Kock ,SA
1122,122,121,165,148,17,148,0,5 (5ct 0st),1.3630000000000002,1991,1998,DJ Richardson ,SA
1123,375,372,160,160,0,0,160,3 (3ct 0st),0.43,1995,2012,RT Ponting ,AUS
1124,334,332,156,156,0,0,156,4 (4ct 0st),0.469,1985,2000,M Azharuddin ,INDIA
1125,140,139,154,110,44,110,0,5 (4ct 1st),1.107,1994,2000,NR Mongia ,INDIA
1126,193,193,154,125,29,96,29,5 (5ct 0st),0.797,2004,2019,BRM Taylor ,ZIM
1127,150,150,147,114,33,112,2,4 (4ct 0st),0.98,2001,2012,T Taibu ,ZIM
1128,179,178,141,116,25,111,5,5 (3ct 2st),0.792,1992,2002,AC Parore ,NZ
1129,116,114,140,116,24,116,0,6 (6ct 0st),1.228,2007,2019,Sarfaraz Ahmed ,PAK
1130,463,456,140,140,0,0,140,4 (4ct 0st),0.307,1989,2012,SR Tendulkar ,INDIA
1131,228,224,137,137,0,0,137,4 (4ct 0st),0.611,2006,2019,LRPL Taylor ,NZ
1132,265,260,135,135,0,5,130,4 (4ct 0st),0.519,2000,2015,Younis Khan ,PAK
1133,280,276,133,133,0,0,133,4 (4ct 0st),0.481,1994,2007,SP Fleming ,NZ
1134,328,324,131,131,0,0,131,3 (3ct 0st),0.4039999999999999,1996,2014,JH Kallis ,SA
1135,350,347,130,130,0,0,130,3 (3ct 0st),0.374,1993,2011,M Muralitharan ,SL
1136,273,270,127,127,0,0,127,3 (3ct 0st),0.47,1979,1994,AR Border ,AUS
1137,398,392,127,127,0,0,127,2 (2ct 0st),0.3229999999999999,1996,2015,Shahid Afridi ,PAK
1138,126,126,126,91,35,91,0,5 (3ct 2st),1.0,1995,2006,Khaled Mashud ,BDESH
1139,330,325,124,123,1,5,118,3 (3ct 0st),0.381,1999,2016,TM Dilshan ,SL
1140,301,294,124,124,0,0,124,3 (3ct 0st),0.421,1999,2019,CH Gayle ,WI
1141,242,240,124,124,0,0,124,3 (3ct 0st),0.516,2008,2019,V Kohli ,INDIA
1142,92,92,124,120,4,120,0,5 (5ct 0st),1.347,1971,1984,RW Marsh ,AUS
1143,445,441,123,123,0,0,123,3 (3ct 0st),0.278,1989,2011,ST Jayasuriya ,SL
1144,227,225,120,120,0,0,120,4 (4ct 0st),0.5329999999999999,1987,2003,CL Hooper ,WI
1145,299,296,120,120,0,0,120,3 (3ct 0st),0.405,1990,2007,BC Lara ,WI
1146,85,83,117,105,12,105,0,4 (4ct 0st),1.409,2008,2017,L Ronchi ,AUS
1147,94,94,117,108,9,108,0,5 (5ct 0st),1.244,2012,2017,MS Wade ,AUS
1148,378,373,113,113,0,0,113,3 (3ct 0st),0.302,1991,2007,Inzamam-ul-Haq ,PAK
1149,325,324,111,111,0,0,111,3 (3ct 0st),0.342,1986,2002,SR Waugh ,AUS
1150,404,397,501,402,99,383,19,5 (4ct 1st),1.261,2000,2015,KC Sangakkara ,SL
1151,287,286,472,417,55,417,0,6 (6ct 0st),1.65,1996,2008,AC Gilchrist ,AUS
1152,350,345,444,321,123,321,0,6 (5ct 1st),1.286,2004,2019,MS Dhoni ,INDIA
1153,295,291,425,403,22,402,1,6 (6ct 0st),1.46,1998,2011,MV Boucher ,SA
1154,219,217,287,214,73,214,0,5 (5ct 0st),1.3219999999999998,1990,2004,Moin Khan ,PAK
1155,260,257,277,262,15,227,35,5 (5ct 0st),1.077,2002,2016,BB McCullum ,NZ
1156,168,168,233,194,39,194,0,4 (4ct 0st),1.386,1988,1997,IA Healy ,AUS
1157,216,215,225,181,44,179,2,5 (5ct 0st),1.046,2006,2019,Mushfiqur Rahim ,BDESH
1158,166,164,220,182,38,182,0,5 (5ct 0st),1.341,1992,2003,Rashid Latif ,PAK
1159,448,443,218,218,0,0,218,4 (4ct 0st),0.492,1998,2015,DPMD Jayawardene ,SL
1160,344,341,210,196,14,72,124,4 (4ct 0st),0.615,1996,2011,R Dravid ,INDIA
1161,189,188,207,132,75,131,1,5 (4ct 1st),1.101,1990,2004,RS Kaluwitharana ,SL
1162,169,168,204,183,21,183,0,4 (4ct 0st),1.214,1981,1991,PJL Dujon ,WI
1163,142,138,202,171,31,171,0,6 (6ct 0st),1.463,2012,2019,JC Buttler ,ENG
1164,147,145,189,160,29,160,0,6 (5ct 1st),1.3030000000000002,1996,2004,RD Jacobs ,WI
1165,157,154,188,157,31,156,1,5 (4ct 1st),1.22,2002,2017,Kamran Akmal ,PAK
1166,139,137,188,181,7,181,0,5 (5ct 0st),1.372,2005,2016,D Ramdin ,WI
1167,228,223,181,176,5,93,83,5 (5ct 0st),0.8109999999999999,2005,2018,AB de Villiers ,SA
1168,126,124,181,170,11,170,0,5 (5ct 0st),1.459,2001,2015,BJ Haddin ,AUS
1169,170,169,174,159,15,148,11,6 (6ct 0st),1.029,1989,2003,AJ Stewart ,ENG
1170,213,212,173,141,32,133,8,5 (5ct 0st),0.816,1992,2003,A Flower ,ZIM
1171,115,111,166,158,8,158,0,6 (5ct 1st),1.495,2013,2019,Q de Kock ,SA
1172,122,121,165,148,17,148,0,5 (5ct 0st),1.3630000000000002,1991,1998,DJ Richardson ,SA
1173,375,372,160,160,0,0,160,3 (3ct 0st),0.43,1995,2012,RT Ponting ,AUS
1174,334,332,156,156,0,0,156,4 (4ct 0st),0.469,1985,2000,M Azharuddin ,INDIA
1175,140,139,154,110,44,110,0,5 (4ct 1st),1.107,1994,2000,NR Mongia ,INDIA
1176,193,193,154,125,29,96,29,5 (5ct 0st),0.797,2004,2019,BRM Taylor ,ZIM
1177,150,150,147,114,33,112,2,4 (4ct 0st),0.98,2001,2012,T Taibu ,ZIM
1178,179,178,141,116,25,111,5,5 (3ct 2st),0.792,1992,2002,AC Parore ,NZ
1179,116,114,140,116,24,116,0,6 (6ct 0st),1.228,2007,2019,Sarfaraz Ahmed ,PAK
1180,463,456,140,140,0,0,140,4 (4ct 0st),0.307,1989,2012,SR Tendulkar ,INDIA
1181,228,224,137,137,0,0,137,4 (4ct 0st),0.611,2006,2019,LRPL Taylor ,NZ
1182,265,260,135,135,0,5,130,4 (4ct 0st),0.519,2000,2015,Younis Khan ,PAK
1183,280,276,133,133,0,0,133,4 (4ct 0st),0.481,1994,2007,SP Fleming ,NZ
1184,328,324,131,131,0,0,131,3 (3ct 0st),0.4039999999999999,1996,2014,JH Kallis ,SA
1185,350,347,130,130,0,0,130,3 (3ct 0st),0.374,1993,2011,M Muralitharan ,SL
1186,273,270,127,127,0,0,127,3 (3ct 0st),0.47,1979,1994,AR Border ,AUS
1187,398,392,127,127,0,0,127,2 (2ct 0st),0.3229999999999999,1996,2015,Shahid Afridi ,PAK
1188,126,126,126,91,35,91,0,5 (3ct 2st),1.0,1995,2006,Khaled Mashud ,BDESH
1189,330,325,124,123,1,5,118,3 (3ct 0st),0.381,1999,2016,TM Dilshan ,SL
1190,301,294,124,124,0,0,124,3 (3ct 0st),0.421,1999,2019,CH Gayle ,WI
1191,242,240,124,124,0,0,124,3 (3ct 0st),0.516,2008,2019,V Kohli ,INDIA
1192,92,92,124,120,4,120,0,5 (5ct 0st),1.347,1971,1984,RW Marsh ,AUS
1193,445,441,123,123,0,0,123,3 (3ct 0st),0.278,1989,2011,ST Jayasuriya ,SL
1194,227,225,120,120,0,0,120,4 (4ct 0st),0.5329999999999999,1987,2003,CL Hooper ,WI
1195,299,296,120,120,0,0,120,3 (3ct 0st),0.405,1990,2007,BC Lara ,WI
1196,85,83,117,105,12,105,0,4 (4ct 0st),1.409,2008,2017,L Ronchi ,AUS
1197,94,94,117,108,9,108,0,5 (5ct 0st),1.244,2012,2017,MS Wade ,AUS
1198,378,373,113,113,0,0,113,3 (3ct 0st),0.302,1991,2007,Inzamam-ul-Haq ,PAK
1199,325,324,111,111,0,0,111,3 (3ct 0st),0.342,1986,2002,SR Waugh ,AUS
1200,404,397,501,402,99,383,19,5 (4ct 1st),1.261,2000,2015,KC Sangakkara ,SL
1201,287,286,472,417,55,417,0,6 (6ct 0st),1.65,1996,2008,AC Gilchrist ,AUS
1202,350,345,444,321,123,321,0,6 (5ct 1st),1.286,2004,2019,MS Dhoni ,INDIA
1203,295,291,425,403,22,402,1,6 (6ct 0st),1.46,1998,2011,MV Boucher ,SA
1204,219,217,287,214,73,214,0,5 (5ct 0st),1.3219999999999998,1990,2004,Moin Khan ,PAK
1205,260,257,277,262,15,227,35,5 (5ct 0st),1.077,2002,2016,BB McCullum ,NZ
1206,168,168,233,194,39,194,0,4 (4ct 0st),1.386,1988,1997,IA Healy ,AUS
1207,216,215,225,181,44,179,2,5 (5ct 0st),1.046,2006,2019,Mushfiqur Rahim ,BDESH
1208,166,164,220,182,38,182,0,5 (5ct 0st),1.341,1992,2003,Rashid Latif ,PAK
1209,448,443,218,218,0,0,218,4 (4ct 0st),0.492,1998,2015,DPMD Jayawardene ,SL
1210,344,341,210,196,14,72,124,4 (4ct 0st),0.615,1996,2011,R Dravid ,INDIA
1211,189,188,207,132,75,131,1,5 (4ct 1st),1.101,1990,2004,RS Kaluwitharana ,SL
1212,169,168,204,183,21,183,0,4 (4ct 0st),1.214,1981,1991,PJL Dujon ,WI
1213,142,138,202,171,31,171,0,6 (6ct 0st),1.463,2012,2019,JC Buttler ,ENG
1214,147,145,189,160,29,160,0,6 (5ct 1st),1.3030000000000002,1996,2004,RD Jacobs ,WI
1215,157,154,188,157,31,156,1,5 (4ct 1st),1.22,2002,2017,Kamran Akmal ,PAK
1216,139,137,188,181,7,181,0,5 (5ct 0st),1.372,2005,2016,D Ramdin ,WI
1217,228,223,181,176,5,93,83,5 (5ct 0st),0.8109999999999999,2005,2018,AB de Villiers ,SA
1218,126,124,181,170,11,170,0,5 (5ct 0st),1.459,2001,2015,BJ Haddin ,AUS
1219,170,169,174,159,15,148,11,6 (6ct 0st),1.029,1989,2003,AJ Stewart ,ENG
1220,213,212,173,141,32,133,8,5 (5ct 0st),0.816,1992,2003,A Flower ,ZIM
1221,115,111,166,158,8,158,0,6 (5ct 1st),1.495,2013,2019,Q de Kock ,SA
1222,122,121,165,148,17,148,0,5 (5ct 0st),1.3630000000000002,1991,1998,DJ Richardson ,SA
1223,375,372,160,160,0,0,160,3 (3ct 0st),0.43,1995,2012,RT Ponting ,AUS
1224,334,332,156,156,0,0,156,4 (4ct 0st),0.469,1985,2000,M Azharuddin ,INDIA
1225,140,139,154,110,44,110,0,5 (4ct 1st),1.107,1994,2000,NR Mongia ,INDIA
1226,193,193,154,125,29,96,29,5 (5ct 0st),0.797,2004,2019,BRM Taylor ,ZIM
1227,150,150,147,114,33,112,2,4 (4ct 0st),0.98,2001,2012,T Taibu ,ZIM
1228,179,178,141,116,25,111,5,5 (3ct 2st),0.792,1992,2002,AC Parore ,NZ
1229,116,114,140,116,24,116,0,6 (6ct 0st),1.228,2007,2019,Sarfaraz Ahmed ,PAK
1230,463,456,140,140,0,0,140,4 (4ct 0st),0.307,1989,2012,SR Tendulkar ,INDIA
1231,228,224,137,137,0,0,137,4 (4ct 0st),0.611,2006,2019,LRPL Taylor ,NZ
1232,265,260,135,135,0,5,130,4 (4ct 0st),0.519,2000,2015,Younis Khan ,PAK
1233,280,276,133,133,0,0,133,4 (4ct 0st),0.481,1994,2007,SP Fleming ,NZ
1234,328,324,131,131,0,0,131,3 (3ct 0st),0.4039999999999999,1996,2014,JH Kallis ,SA
1235,350,347,130,130,0,0,130,3 (3ct 0st),0.374,1993,2011,M Muralitharan ,SL
1236,273,270,127,127,0,0,127,3 (3ct 0st),0.47,1979,1994,AR Border ,AUS
1237,398,392,127,127,0,0,127,2 (2ct 0st),0.3229999999999999,1996,2015,Shahid Afridi ,PAK
1238,126,126,126,91,35,91,0,5 (3ct 2st),1.0,1995,2006,Khaled Mashud ,BDESH
1239,330,325,124,123,1,5,118,3 (3ct 0st),0.381,1999,2016,TM Dilshan ,SL
1240,301,294,124,124,0,0,124,3 (3ct 0st),0.421,1999,2019,CH Gayle ,WI
1241,242,240,124,124,0,0,124,3 (3ct 0st),0.516,2008,2019,V Kohli ,INDIA
1242,92,92,124,120,4,120,0,5 (5ct 0st),1.347,1971,1984,RW Marsh ,AUS
1243,445,441,123,123,0,0,123,3 (3ct 0st),0.278,1989,2011,ST Jayasuriya ,SL
1244,227,225,120,120,0,0,120,4 (4ct 0st),0.5329999999999999,1987,2003,CL Hooper ,WI
1245,299,296,120,120,0,0,120,3 (3ct 0st),0.405,1990,2007,BC Lara ,WI
1246,85,83,117,105,12,105,0,4 (4ct 0st),1.409,2008,2017,L Ronchi ,AUS
1247,94,94,117,108,9,108,0,5 (5ct 0st),1.244,2012,2017,MS Wade ,AUS
1248,378,373,113,113,0,0,113,3 (3ct 0st),0.302,1991,2007,Inzamam-ul-Haq ,PAK
1249,325,324,111,111,0,0,111,3 (3ct 0st),0.342,1986,2002,SR Waugh ,AUS
1250,404,397,501,402,99,383,19,5 (4ct 1st),1.261,2000,2015,KC Sangakkara ,SL
1251,287,286,472,417,55,417,0,6 (6ct 0st),1.65,1996,2008,AC Gilchrist ,AUS
1252,350,345,444,321,123,321,0,6 (5ct 1st),1.286,2004,2019,MS Dhoni ,INDIA
1253,295,291,425,403,22,402,1,6 (6ct 0st),1.46,1998,2011,MV Boucher ,SA
1254,219,217,287,214,73,214,0,5 (5ct 0st),1.3219999999999998,1990,2004,Moin Khan ,PAK
1255,260,257,277,262,15,227,35,5 (5ct 0st),1.077,2002,2016,BB McCullum ,NZ
1256,168,168,233,194,39,194,0,4 (4ct 0st),1.386,1988,1997,IA Healy ,AUS
1257,216,215,225,181,44,179,2,5 (5ct 0st),1.046,2006,2019,Mushfiqur Rahim ,BDESH
1258,166,164,220,182,38,182,0,5 (5ct 0st),1.341,1992,2003,Rashid Latif ,PAK
1259,448,443,218,218,0,0,218,4 (4ct 0st),0.492,1998,2015,DPMD Jayawardene ,SL
1260,344,341,210,196,14,72,124,4 (4ct 0st),0.615,1996,2011,R Dravid ,INDIA
1261,189,188,207,132,75,131,1,5 (4ct 1st),1.101,1990,2004,RS Kaluwitharana ,SL
1262,169,168,204,183,21,183,0,4 (4ct 0st),1.214,1981,1991,PJL Dujon ,WI
1263,142,138,202,171,31,171,0,6 (6ct 0st),1.463,2012,2019,JC Buttler ,ENG
1264,147,145,189,160,29,160,0,6 (5ct 1st),1.3030000000000002,1996,2004,RD Jacobs ,WI
1265,157,154,188,157,31,156,1,5 (4ct 1st),1.22,2002,2017,Kamran Akmal ,PAK
1266,139,137,188,181,7,181,0,5 (5ct 0st),1.372,2005,2016,D Ramdin ,WI
1267,228,223,181,176,5,93,83,5 (5ct 0st),0.8109999999999999,2005,2018,AB de Villiers ,SA
1268,126,124,181,170,11,170,0,5 (5ct 0st),1.459,2001,2015,BJ Haddin ,AUS
1269,170,169,174,159,15,148,11,6 (6ct 0st),1.029,1989,2003,AJ Stewart ,ENG
1270,213,212,173,141,32,133,8,5 (5ct 0st),0.816,1992,2003,A Flower ,ZIM
1271,115,111,166,158,8,158,0,6 (5ct 1st),1.495,2013,2019,Q de Kock ,SA
1272,122,121,165,148,17,148,0,5 (5ct 0st),1.3630000000000002,1991,1998,DJ Richardson ,SA
1273,375,372,160,160,0,0,160,3 (3ct 0st),0.43,1995,2012,RT Ponting ,AUS
1274,334,332,156,156,0,0,156,4 (4ct 0st),0.469,1985,2000,M Azharuddin ,INDIA
1275,140,139,154,110,44,110,0,5 (4ct 1st),1.107,1994,2000,NR Mongia ,INDIA
1276,193,193,154,125,29,96,29,5 (5ct 0st),0.797,2004,2019,BRM Taylor ,ZIM
1277,150,150,147,114,33,112,2,4 (4ct 0st),0.98,2001,2012,T Taibu ,ZIM
1278,179,178,141,116,25,111,5,5 (3ct 2st),0.792,1992,2002,AC Parore ,NZ
1279,116,114,140,116,24,116,0,6 (6ct 0st),1.228,2007,2019,Sarfaraz Ahmed ,PAK
1280,463,456,140,140,0,0,140,4 (4ct 0st),0.307,1989,2012,SR Tendulkar ,INDIA
1281,228,224,137,137,0,0,137,4 (4ct 0st),0.611,2006,2019,LRPL Taylor ,NZ
1282,265,260,135,135,0,5,130,4 (4ct 0st),0.519,2000,2015,Younis Khan ,PAK
1283,280,276,133,133,0,0,133,4 (4ct 0st),0.481,1994,2007,SP Fleming ,NZ
1284,328,324,131,131,0,0,131,3 (3ct 0st),0.4039999999999999,1996,2014,JH Kallis ,SA
1285,350,347,130,130,0,0,130,3 (3ct 0st),0.374,1993,2011,M Muralitharan ,SL
1286,273,270,127,127,0,0,127,3 (3ct 0st),0.47,1979,1994,AR Border ,AUS
1287,398,392,127,127,0,0,127,2 (2ct 0st),0.3229999999999999,1996,2015,Shahid Afridi ,PAK
1288,126,126,126,91,35,91,0,5 (3ct 2st),1.0,1995,2006,Khaled Mashud ,BDESH
1289,330,325,124,123,1,5,118,3 (3ct 0st),0.381,1999,2016,TM Dilshan ,SL
1290,301,294,124,124,0,0,124,3 (3ct 0st),0.421,1999,2019,CH Gayle ,WI
1291,242,240,124,124,0,0,124,3 (3ct 0st),0.516,2008,2019,V Kohli ,INDIA
1292,92,92,124,120,4,120,0,5 (5ct 0st),1.347,1971,1984,RW Marsh ,AUS
1293,445,441,123,123,0,0,123,3 (3ct 0st),0.278,1989,2011,ST Jayasuriya ,SL
1294,227,225,120,120,0,0,120,4 (4ct 0st),0.5329999999999999,1987,2003,CL Hooper ,WI
1295,299,296,120,120,0,0,120,3 (3ct 0st),0.405,1990,2007,BC Lara ,WI
1296,85,83,117,105,12,105,0,4 (4ct 0st),1.409,2008,2017,L Ronchi ,AUS
1297,94,94,117,108,9,108,0,5 (5ct 0st),1.244,2012,2017,MS Wade ,AUS
1298,378,373,113,113,0,0,113,3 (3ct 0st),0.302,1991,2007,Inzamam-ul-Haq ,PAK
1299,325,324,111,111,0,0,111,3 (3ct 0st),0.342,1986,2002,SR Waugh ,AUS
1300,404,397,501,402,99,383,19,5 (4ct 1st),1.261,2000,2015,KC Sangakkara ,SL
1301,287,286,472,417,55,417,0,6 (6ct 0st),1.65,1996,2008,AC Gilchrist ,AUS
1302,350,345,444,321,123,321,0,6 (5ct 1st),1.286,2004,2019,MS Dhoni ,INDIA
1303,295,291,425,403,22,402,1,6 (6ct 0st),1.46,1998,2011,MV Boucher ,SA
1304,219,217,287,214,73,214,0,5 (5ct 0st),1.3219999999999998,1990,2004,Moin Khan ,PAK
1305,260,257,277,262,15,227,35,5 (5ct 0st),1.077,2002,2016,BB McCullum ,NZ
1306,168,168,233,194,39,194,0,4 (4ct 0st),1.386,1988,1997,IA Healy ,AUS
1307,216,215,225,181,44,179,2,5 (5ct 0st),1.046,2006,2019,Mushfiqur Rahim ,BDESH
1308,166,164,220,182,38,182,0,5 (5ct 0st),1.341,1992,2003,Rashid Latif ,PAK
1309,448,443,218,218,0,0,218,4 (4ct 0st),0.492,1998,2015,DPMD Jayawardene ,SL
1310,344,341,210,196,14,72,124,4 (4ct 0st),0.615,1996,2011,R Dravid ,INDIA
1311,189,188,207,132,75,131,1,5 (4ct 1st),1.101,1990,2004,RS Kaluwitharana ,SL
1312,169,168,204,183,21,183,0,4 (4ct 0st),1.214,1981,1991,PJL Dujon ,WI
1313,142,138,202,171,31,171,0,6 (6ct 0st),1.463,2012,2019,JC Buttler ,ENG
1314,147,145,189,160,29,160,0,6 (5ct 1st),1.3030000000000002,1996,2004,RD Jacobs ,WI
1315,157,154,188,157,31,156,1,5 (4ct 1st),1.22,2002,2017,Kamran Akmal ,PAK
1316,139,137,188,181,7,181,0,5 (5ct 0st),1.372,2005,2016,D Ramdin ,WI
1317,228,223,181,176,5,93,83,5 (5ct 0st),0.8109999999999999,2005,2018,AB de Villiers ,SA
1318,126,124,181,170,11,170,0,5 (5ct 0st),1.459,2001,2015,BJ Haddin ,AUS
1319,170,169,174,159,15,148,11,6 (6ct 0st),1.029,1989,2003,AJ Stewart ,ENG
1320,213,212,173,141,32,133,8,5 (5ct 0st),0.816,1992,2003,A Flower ,ZIM
1321,115,111,166,158,8,158,0,6 (5ct 1st),1.495,2013,2019,Q de Kock ,SA
1322,122,121,165,148,17,148,0,5 (5ct 0st),1.3630000000000002,1991,1998,DJ Richardson ,SA
1323,375,372,160,160,0,0,160,3 (3ct 0st),0.43,1995,2012,RT Ponting ,AUS
1324,334,332,156,156,0,0,156,4 (4ct 0st),0.469,1985,2000,M Azharuddin ,INDIA
1325,140,139,154,110,44,110,0,5 (4ct 1st),1.107,1994,2000,NR Mongia ,INDIA
1326,193,193,154,125,29,96,29,5 (5ct 0st),0.797,2004,2019,BRM Taylor ,ZIM
1327,150,150,147,114,33,112,2,4 (4ct 0st),0.98,2001,2012,T Taibu ,ZIM
1328,179,178,141,116,25,111,5,5 (3ct 2st),0.792,1992,2002,AC Parore ,NZ
1329,116,114,140,116,24,116,0,6 (6ct 0st),1.228,2007,2019,Sarfaraz Ahmed ,PAK
1330,463,456,140,140,0,0,140,4 (4ct 0st),0.307,1989,2012,SR Tendulkar ,INDIA
1331,228,224,137,137,0,0,137,4 (4ct 0st),0.611,2006,2019,LRPL Taylor ,NZ
1332,265,260,135,135,0,5,130,4 (4ct 0st),0.519,2000,2015,Younis Khan ,PAK
1333,280,276,133,133,0,0,133,4 (4ct 0st),0.481,1994,2007,SP Fleming ,NZ
1334,328,324,131,131,0,0,131,3 (3ct 0st),0.4039999999999999,1996,2014,JH Kallis ,SA
1335,350,347,130,130,0,0,130,3 (3ct 0st),0.374,1993,2011,M Muralitharan ,SL
1336,273,270,127,127,0,0,127,3 (3ct 0st),0.47,1979,1994,AR Border ,AUS
1337,398,392,127,127,0,0,127,2 (2ct 0st),0.3229999999999999,1996,2015,Shahid Afridi ,PAK
1338,126,126,126,91,35,91,0,5 (3ct 2st),1.0,1995,2006,Khaled Mashud ,BDESH
1339,330,325,124,123,1,5,118,3 (3ct 0st),0.381,1999,2016,TM Dilshan ,SL
1340,301,294,124,124,0,0,124,3 (3ct 0st),0.421,1999,2019,CH Gayle ,WI
1341,242,240,124,124,0,0,124,3 (3ct 0st),0.516,2008,2019,V Kohli ,INDIA
1342,92,92,124,120,4,120,0,5 (5ct 0st),1.347,1971,1984,RW Marsh ,AUS
1343,445,441,123,123,0,0,123,3 (3ct 0st),0.278,1989,2011,ST Jayasuriya ,SL
1344,227,225,120,120,0,0,120,4 (4ct 0st),0.5329999999999999,1987,2003,CL Hooper ,WI
1345,299,296,120,120,0,0,120,3 (3ct 0st),0.405,1990,2007,BC Lara ,WI
1346,85,83,117,105,12,105,0,4 (4ct 0st),1.409,2008,2017,L Ronchi ,AUS
1347,94,94,117,108,9,108,0,5 (5ct 0st),1.244,2012,2017,MS Wade ,AUS
1348,378,373,113,113,0,0,113,3 (3ct 0st),0.302,1991,2007,Inzamam-ul-Haq ,PAK
1349,325,324,111,111,0,0,111,3 (3ct 0st),0.342,1986,2002,SR Waugh ,AUS
1350,404,397,501,402,99,383,19,5 (4ct 1st),1.261,2000,2015,KC Sangakkara ,SL
1351,287,286,472,417,55,417,0,6 (6ct 0st),1.65,1996,2008,AC Gilchrist ,AUS
1352,350,345,444,321,123,321,0,6 (5ct 1st),1.286,2004,2019,MS Dhoni ,INDIA
1353,295,291,425,403,22,402,1,6 (6ct 0st),1.46,1998,2011,MV Boucher ,SA
1354,219,217,287,214,73,214,0,5 (5ct 0st),1.3219999999999998,1990,2004,Moin Khan ,PAK
1355,260,257,277,262,15,227,35,5 (5ct 0st),1.077,2002,2016,BB McCullum ,NZ
1356,168,168,233,194,39,194,0,4 (4ct 0st),1.386,1988,1997,IA Healy ,AUS
1357,216,215,225,181,44,179,2,5 (5ct 0st),1.046,2006,2019,Mushfiqur Rahim ,BDESH
1358,166,164,220,182,38,182,0,5 (5ct 0st),1.341,1992,2003,Rashid Latif ,PAK
1359,448,443,218,218,0,0,218,4 (4ct 0st),0.492,1998,2015,DPMD Jayawardene ,SL
1360,344,341,210,196,14,72,124,4 (4ct 0st),0.615,1996,2011,R Dravid ,INDIA
1361,189,188,207,132,75,131,1,5 (4ct 1st),1.101,1990,2004,RS Kaluwitharana ,SL
1362,169,168,204,183,21,183,0,4 (4ct 0st),1.214,1981,1991,PJL Dujon ,WI
1363,142,138,202,171,31,171,0,6 (6ct 0st),1.463,2012,2019,JC Buttler ,ENG
1364,147,145,189,160,29,160,0,6 (5ct 1st),1.3030000000000002,1996,2004,RD Jacobs ,WI
1365,157,154,188,157,31,156,1,5 (4ct 1st),1.22,2002,2017,Kamran Akmal ,PAK
1366,139,137,188,181,7,181,0,5 (5ct 0st),1.372,2005,2016,D Ramdin ,WI
1367,228,223,181,176,5,93,83,5 (5ct 0st),0.8109999999999999,2005,2018,AB de Villiers ,SA
1368,126,124,181,170,11,170,0,5 (5ct 0st),1.459,2001,2015,BJ Haddin ,AUS
1369,170,169,174,159,15,148,11,6 (6ct 0st),1.029,1989,2003,AJ Stewart ,ENG
1370,213,212,173,141,32,133,8,5 (5ct 0st),0.816,1992,2003,A Flower ,ZIM
1371,115,111,166,158,8,158,0,6 (5ct 1st),1.495,2013,2019,Q de Kock ,SA
1372,122,121,165,148,17,148,0,5 (5ct 0st),1.3630000000000002,1991,1998,DJ Richardson ,SA
1373,375,372,160,160,0,0,160,3 (3ct 0st),0.43,1995,2012,RT Ponting ,AUS
1374,334,332,156,156,0,0,156,4 (4ct 0st),0.469,1985,2000,M Azharuddin ,INDIA
1375,140,139,154,110,44,110,0,5 (4ct 1st),1.107,1994,2000,NR Mongia ,INDIA
1376,193,193,154,125,29,96,29,5 (5ct 0st),0.797,2004,2019,BRM Taylor ,ZIM
1377,150,150,147,114,33,112,2,4 (4ct 0st),0.98,2001,2012,T Taibu ,ZIM
1378,179,178,141,116,25,111,5,5 (3ct 2st),0.792,1992,2002,AC Parore ,NZ
1379,116,114,140,116,24,116,0,6 (6ct 0st),1.228,2007,2019,Sarfaraz Ahmed ,PAK
1380,463,456,140,140,0,0,140,4 (4ct 0st),0.307,1989,2012,SR Tendulkar ,INDIA
1381,228,224,137,137,0,0,137,4 (4ct 0st),0.611,2006,2019,LRPL Taylor ,NZ
1382,265,260,135,135,0,5,130,4 (4ct 0st),0.519,2000,2015,Younis Khan ,PAK
1383,280,276,133,133,0,0,133,4 (4ct 0st),0.481,1994,2007,SP Fleming ,NZ
1384,328,324,131,131,0,0,131,3 (3ct 0st),0.4039999999999999,1996,2014,JH Kallis ,SA
1385,350,347,130,130,0,0,130,3 (3ct 0st),0.374,1993,2011,M Muralitharan ,SL
1386,273,270,127,127,0,0,127,3 (3ct 0st),0.47,1979,1994,AR Border ,AUS
1387,398,392,127,127,0,0,127,2 (2ct 0st),0.3229999999999999,1996,2015,Shahid Afridi ,PAK
1388,126,126,126,91,35,91,0,5 (3ct 2st),1.0,1995,2006,Khaled Mashud ,BDESH
1389,330,325,124,123,1,5,118,3 (3ct 0st),0.381,1999,2016,TM Dilshan ,SL
1390,301,294,124,124,0,0,124,3 (3ct 0st),0.421,1999,2019,CH Gayle ,WI
1391,242,240,124,124,0,0,124,3 (3ct 0st),0.516,2008,2019,V Kohli ,INDIA
1392,92,92,124,120,4,120,0,5 (5ct 0st),1.347,1971,1984,RW Marsh ,AUS
1393,445,441,123,123,0,0,123,3 (3ct 0st),0.278,1989,2011,ST Jayasuriya ,SL
1394,227,225,120,120,0,0,120,4 (4ct 0st),0.5329999999999999,1987,2003,CL Hooper ,WI
1395,299,296,120,120,0,0,120,3 (3ct 0st),0.405,1990,2007,BC Lara ,WI
1396,85,83,117,105,12,105,0,4 (4ct 0st),1.409,2008,2017,L Ronchi ,AUS
1397,94,94,117,108,9,108,0,5 (5ct 0st),1.244,2012,2017,MS Wade ,AUS
1398,378,373,113,113,0,0,113,3 (3ct 0st),0.302,1991,2007,Inzamam-ul-Haq ,PAK
1399,325,324,111,111,0,0,111,3 (3ct 0st),0.342,1986,2002,SR Waugh ,AUS
1400,404,397,501,402,99,383,19,5 (4ct 1st),1.261,2000,2015,KC Sangakkara ,SL
1401,287,286,472,417,55,417,0,6 (6ct 0st),1.65,1996,2008,AC Gilchrist ,AUS
1402,350,345,444,321,123,321,0,6 (5ct 1st),1.286,2004,2019,MS Dhoni ,INDIA
1403,295,291,425,403,22,402,1,6 (6ct 0st),1.46,1998,2011,MV Boucher ,SA
1404,219,217,287,214,73,214,0,5 (5ct 0st),1.3219999999999998,1990,2004,Moin Khan ,PAK
1405,260,257,277,262,15,227,35,5 (5ct 0st),1.077,2002,2016,BB McCullum ,NZ
1406,168,168,233,194,39,194,0,4 (4ct 0st),1.386,1988,1997,IA Healy ,AUS
1407,216,215,225,181,44,179,2,5 (5ct 0st),1.046,2006,2019,Mushfiqur Rahim ,BDESH
1408,166,164,220,182,38,182,0,5 (5ct 0st),1.341,1992,2003,Rashid Latif ,PAK
1409,448,443,218,218,0,0,218,4 (4ct 0st),0.492,1998,2015,DPMD Jayawardene ,SL
1410,344,341,210,196,14,72,124,4 (4ct 0st),0.615,1996,2011,R Dravid ,INDIA
1411,189,188,207,132,75,131,1,5 (4ct 1st),1.101,1990,2004,RS Kaluwitharana ,SL
1412,169,168,204,183,21,183,0,4 (4ct 0st),1.214,1981,1991,PJL Dujon ,WI
1413,142,138,202,171,31,171,0,6 (6ct 0st),1.463,2012,2019,JC Buttler ,ENG
1414,147,145,189,160,29,160,0,6 (5ct 1st),1.3030000000000002,1996,2004,RD Jacobs ,WI
1415,157,154,188,157,31,156,1,5 (4ct 1st),1.22,2002,2017,Kamran Akmal ,PAK
1416,139,137,188,181,7,181,0,5 (5ct 0st),1.372,2005,2016,D Ramdin ,WI
1417,228,223,181,176,5,93,83,5 (5ct 0st),0.8109999999999999,2005,2018,AB de Villiers ,SA
1418,126,124,181,170,11,170,0,5 (5ct 0st),1.459,2001,2015,BJ Haddin ,AUS
1419,170,169,174,159,15,148,11,6 (6ct 0st),1.029,1989,2003,AJ Stewart ,ENG
1420,213,212,173,141,32,133,8,5 (5ct 0st),0.816,1992,2003,A Flower ,ZIM
1421,115,111,166,158,8,158,0,6 (5ct 1st),1.495,2013,2019,Q de Kock ,SA
1422,122,121,165,148,17,148,0,5 (5ct 0st),1.3630000000000002,1991,1998,DJ Richardson ,SA
1423,375,372,160,160,0,0,160,3 (3ct 0st),0.43,1995,2012,RT Ponting ,AUS
1424,334,332,156,156,0,0,156,4 (4ct 0st),0.469,1985,2000,M Azharuddin ,INDIA
1425,140,139,154,110,44,110,0,5 (4ct 1st),1.107,1994,2000,NR Mongia ,INDIA
1426,193,193,154,125,29,96,29,5 (5ct 0st),0.797,2004,2019,BRM Taylor ,ZIM
1427,150,150,147,114,33,112,2,4 (4ct 0st),0.98,2001,2012,T Taibu ,ZIM
1428,179,178,141,116,25,111,5,5 (3ct 2st),0.792,1992,2002,AC Parore ,NZ
1429,116,114,140,116,24,116,0,6 (6ct 0st),1.228,2007,2019,Sarfaraz Ahmed ,PAK
1430,463,456,140,140,0,0,140,4 (4ct 0st),0.307,1989,2012,SR Tendulkar ,INDIA
1431,228,224,137,137,0,0,137,4 (4ct 0st),0.611,2006,2019,LRPL Taylor ,NZ
1432,265,260,135,135,0,5,130,4 (4ct 0st),0.519,2000,2015,Younis Khan ,PAK
1433,280,276,133,133,0,0,133,4 (4ct 0st),0.481,1994,2007,SP Fleming ,NZ
1434,328,324,131,131,0,0,131,3 (3ct 0st),0.4039999999999999,1996,2014,JH Kallis ,SA
1435,350,347,130,130,0,0,130,3 (3ct 0st),0.374,1993,2011,M Muralitharan ,SL
1436,273,270,127,127,0,0,127,3 (3ct 0st),0.47,1979,1994,AR Border ,AUS
1437,398,392,127,127,0,0,127,2 (2ct 0st),0.3229999999999999,1996,2015,Shahid Afridi ,PAK
1438,126,126,126,91,35,91,0,5 (3ct 2st),1.0,1995,2006,Khaled Mashud ,BDESH
1439,330,325,124,123,1,5,118,3 (3ct 0st),0.381,1999,2016,TM Dilshan ,SL
1440,301,294,124,124,0,0,124,3 (3ct 0st),0.421,1999,2019,CH Gayle ,WI
1441,242,240,124,124,0,0,124,3 (3ct 0st),0.516,2008,2019,V Kohli ,INDIA
1442,92,92,124,120,4,120,0,5 (5ct 0st),1.347,1971,1984,RW Marsh ,AUS
1443,445,441,123,123,0,0,123,3 (3ct 0st),0.278,1989,2011,ST Jayasuriya ,SL
1444,227,225,120,120,0,0,120,4 (4ct 0st),0.5329999999999999,1987,2003,CL Hooper ,WI
1445,299,296,120,120,0,0,120,3 (3ct 0st),0.405,1990,2007,BC Lara ,WI
1446,85,83,117,105,12,105,0,4 (4ct 0st),1.409,2008,2017,L Ronchi ,AUS
1447,94,94,117,108,9,108,0,5 (5ct 0st),1.244,2012,2017,MS Wade ,AUS
1448,378,373,113,113,0,0,113,3 (3ct 0st),0.302,1991,2007,Inzamam-ul-Haq ,PAK
1449,325,324,111,111,0,0,111,3 (3ct 0st),0.342,1986,2002,SR Waugh ,AUS
1450,404,397,501,402,99,383,19,5 (4ct 1st),1.261,2000,2015,KC Sangakkara ,SL
1451,287,286,472,417,55,417,0,6 (6ct 0st),1.65,1996,2008,AC Gilchrist ,AUS
1452,350,345,444,321,123,321,0,6 (5ct 1st),1.286,2004,2019,MS Dhoni ,INDIA
1453,295,291,425,403,22,402,1,6 (6ct 0st),1.46,1998,2011,MV Boucher ,SA
1454,219,217,287,214,73,214,0,5 (5ct 0st),1.3219999999999998,1990,2004,Moin Khan ,PAK
1455,260,257,277,262,15,227,35,5 (5ct 0st),1.077,2002,2016,BB McCullum ,NZ
1456,168,168,233,194,39,194,0,4 (4ct 0st),1.386,1988,1997,IA Healy ,AUS
1457,216,215,225,181,44,179,2,5 (5ct 0st),1.046,2006,2019,Mushfiqur Rahim ,BDESH
1458,166,164,220,182,38,182,0,5 (5ct 0st),1.341,1992,2003,Rashid Latif ,PAK
1459,448,443,218,218,0,0,218,4 (4ct 0st),0.492,1998,2015,DPMD Jayawardene ,SL
1460,344,341,210,196,14,72,124,4 (4ct 0st),0.615,1996,2011,R Dravid ,INDIA
1461,189,188,207,132,75,131,1,5 (4ct 1st),1.101,1990,2004,RS Kaluwitharana ,SL
1462,169,168,204,183,21,183,0,4 (4ct 0st),1.214,1981,1991,PJL Dujon ,WI
1463,142,138,202,171,31,171,0,6 (6ct 0st),1.463,2012,2019,JC Buttler ,ENG
1464,147,145,189,160,29,160,0,6 (5ct 1st),1.3030000000000002,1996,2004,RD Jacobs ,WI
1465,157,154,188,157,31,156,1,5 (4ct 1st),1.22,2002,2017,Kamran Akmal ,PAK
1466,139,137,188,181,7,181,0,5 (5ct 0st),1.372,2005,2016,D Ramdin ,WI
1467,228,223,181,176,5,93,83,5 (5ct 0st),0.8109999999999999,2005,2018,AB de Villiers ,SA
1468,126,124,181,170,11,170,0,5 (5ct 0st),1.459,2001,2015,BJ Haddin ,AUS
1469,170,169,174,159,15,148,11,6 (6ct 0st),1.029,1989,2003,AJ Stewart ,ENG
1470,213,212,173,141,32,133,8,5 (5ct 0st),0.816,1992,2003,A Flower ,ZIM
1471,115,111,166,158,8,158,0,6 (5ct 1st),1.495,2013,2019,Q de Kock ,SA
1472,122,121,165,148,17,148,0,5 (5ct 0st),1.3630000000000002,1991,1998,DJ Richardson ,SA
1473,375,372,160,160,0,0,160,3 (3ct 0st),0.43,1995,2012,RT Ponting ,AUS
1474,334,332,156,156,0,0,156,4 (4ct 0st),0.469,1985,2000,M Azharuddin ,INDIA
1475,140,139,154,110,44,110,0,5 (4ct 1st),1.107,1994,2000,NR Mongia ,INDIA
1476,193,193,154,125,29,96,29,5 (5ct 0st),0.797,2004,2019,BRM Taylor ,ZIM
1477,150,150,147,114,33,112,2,4 (4ct 0st),0.98,2001,2012,T Taibu ,ZIM
1478,179,178,141,116,25,111,5,5 (3ct 2st),0.792,1992,2002,AC Parore ,NZ
1479,116,114,140,116,24,116,0,6 (6ct 0st),1.228,2007,2019,Sarfaraz Ahmed ,PAK
1480,463,456,140,140,0,0,140,4 (4ct 0st),0.307,1989,2012,SR Tendulkar ,INDIA
1481,228,224,137,137,0,0,137,4 (4ct 0st),0.611,2006,2019,LRPL Taylor ,NZ
1482,265,260,135,135,0,5,130,4 (4ct 0st),0.519,2000,2015,Younis Khan ,PAK
1483,280,276,133,133,0,0,133,4 (4ct 0st),0.481,1994,2007,SP Fleming ,NZ
1484,328,324,131,131,0,0,131,3 (3ct 0st),0.4039999999999999,1996,2014,JH Kallis ,SA
1485,350,347,130,130,0,0,130,3 (3ct 0st),0.374,1993,2011,M Muralitharan ,SL
1486,273,270,127,127,0,0,127,3 (3ct 0st),0.47,1979,1994,AR Border ,AUS
1487,398,392,127,127,0,0,127,2 (2ct 0st),0.3229999999999999,1996,2015,Shahid Afridi ,PAK
1488,126,126,126,91,35,91,0,5 (3ct 2st),1.0,1995,2006,Khaled Mashud ,BDESH
1489,330,325,124,123,1,5,118,3 (3ct 0st),0.381,1999,2016,TM Dilshan ,SL
1490,301,294,124,124,0,0,124,3 (3ct 0st),0.421,1999,2019,CH Gayle ,WI
1491,242,240,124,124,0,0,124,3 (3ct 0st),0.516,2008,2019,V Kohli ,INDIA
1492,92,92,124,120,4,120,0,5 (5ct 0st),1.347,1971,1984,RW Marsh ,AUS
1493,445,441,123,123,0,0,123,3 (3ct 0st),0.278,1989,2011,ST Jayasuriya ,SL
1494,227,225,120,120,0,0,120,4 (4ct 0st),0.5329999999999999,1987,2003,CL Hooper ,WI
1495,299,296,120,120,0,0,120,3 (3ct 0st),0.405,1990,2007,BC Lara ,WI
1496,85,83,117,105,12,105,0,4 (4ct 0st),1.409,2008,2017,L Ronchi ,AUS
1497,94,94,117,108,9,108,0,5 (5ct 0st),1.244,2012,2017,MS Wade ,AUS
1498,378,373,113,113,0,0,113,3 (3ct 0st),0.302,1991,2007,Inzamam-ul-Haq ,PAK
1499,325,324,111,111,0,0,111,3 (3ct 0st),0.342,1986,2002,SR Waugh ,AUS
1500,404,397,501,402,99,383,19,5 (4ct 1st),1.261,2000,2015,KC Sangakkara ,SL
1501,287,286,472,417,55,417,0,6 (6ct 0st),1.65,1996,2008,AC Gilchrist ,AUS
1502,350,345,444,321,123,321,0,6 (5ct 1st),1.286,2004,2019,MS Dhoni ,INDIA
1503,295,291,425,403,22,402,1,6 (6ct 0st),1.46,1998,2011,MV Boucher ,SA
1504,219,217,287,214,73,214,0,5 (5ct 0st),1.3219999999999998,1990,2004,Moin Khan ,PAK
1505,260,257,277,262,15,227,35,5 (5ct 0st),1.077,2002,2016,BB McCullum ,NZ
1506,168,168,233,194,39,194,0,4 (4ct 0st),1.386,1988,1997,IA Healy ,AUS
1507,216,215,225,181,44,179,2,5 (5ct 0st),1.046,2006,2019,Mushfiqur Rahim ,BDESH
1508,166,164,220,182,38,182,0,5 (5ct 0st),1.341,1992,2003,Rashid Latif ,PAK
1509,448,443,218,218,0,0,218,4 (4ct 0st),0.492,1998,2015,DPMD Jayawardene ,SL
1510,344,341,210,196,14,72,124,4 (4ct 0st),0.615,1996,2011,R Dravid ,INDIA
1511,189,188,207,132,75,131,1,5 (4ct 1st),1.101,1990,2004,RS Kaluwitharana ,SL
1512,169,168,204,183,21,183,0,4 (4ct 0st),1.214,1981,1991,PJL Dujon ,WI
1513,142,138,202,171,31,171,0,6 (6ct 0st),1.463,2012,2019,JC Buttler ,ENG
1514,147,145,189,160,29,160,0,6 (5ct 1st),1.3030000000000002,1996,2004,RD Jacobs ,WI
1515,157,154,188,157,31,156,1,5 (4ct 1st),1.22,2002,2017,Kamran Akmal ,PAK
1516,139,137,188,181,7,181,0,5 (5ct 0st),1.372,2005,2016,D Ramdin ,WI
1517,228,223,181,176,5,93,83,5 (5ct 0st),0.8109999999999999,2005,2018,AB de Villiers ,SA
1518,126,124,181,170,11,170,0,5 (5ct 0st),1.459,2001,2015,BJ Haddin ,AUS
1519,170,169,174,159,15,148,11,6 (6ct 0st),1.029,1989,2003,AJ Stewart ,ENG
1520,213,212,173,141,32,133,8,5 (5ct 0st),0.816,1992,2003,A Flower ,ZIM
1521,115,111,166,158,8,158,0,6 (5ct 1st),1.495,2013,2019,Q de Kock ,SA
1522,122,121,165,148,17,148,0,5 (5ct 0st),1.3630000000000002,1991,1998,DJ Richardson ,SA
1523,375,372,160,160,0,0,160,3 (3ct 0st),0.43,1995,2012,RT Ponting ,AUS
1524,334,332,156,156,0,0,156,4 (4ct 0st),0.469,1985,2000,M Azharuddin ,INDIA
1525,140,139,154,110,44,110,0,5 (4ct 1st),1.107,1994,2000,NR Mongia ,INDIA
1526,193,193,154,125,29,96,29,5 (5ct 0st),0.797,2004,2019,BRM Taylor ,ZIM
1527,150,150,147,114,33,112,2,4 (4ct 0st),0.98,2001,2012,T Taibu ,ZIM
1528,179,178,141,116,25,111,5,5 (3ct 2st),0.792,1992,2002,AC Parore ,NZ
1529,116,114,140,116,24,116,0,6 (6ct 0st),1.228,2007,2019,Sarfaraz Ahmed ,PAK
1530,463,456,140,140,0,0,140,4 (4ct 0st),0.307,1989,2012,SR Tendulkar ,INDIA
1531,228,224,137,137,0,0,137,4 (4ct 0st),0.611,2006,2019,LRPL Taylor ,NZ
1532,265,260,135,135,0,5,130,4 (4ct 0st),0.519,2000,2015,Younis Khan ,PAK
1533,280,276,133,133,0,0,133,4 (4ct 0st),0.481,1994,2007,SP Fleming ,NZ
1534,328,324,131,131,0,0,131,3 (3ct 0st),0.4039999999999999,1996,2014,JH Kallis ,SA
1535,350,347,130,130,0,0,130,3 (3ct 0st),0.374,1993,2011,M Muralitharan ,SL
1536,273,270,127,127,0,0,127,3 (3ct 0st),0.47,1979,1994,AR Border ,AUS
1537,398,392,127,127,0,0,127,2 (2ct 0st),0.3229999999999999,1996,2015,Shahid Afridi ,PAK
1538,126,126,126,91,35,91,0,5 (3ct 2st),1.0,1995,2006,Khaled Mashud ,BDESH
1539,330,325,124,123,1,5,118,3 (3ct 0st),0.381,1999,2016,TM Dilshan ,SL
1540,301,294,124,124,0,0,124,3 (3ct 0st),0.421,1999,2019,CH Gayle ,WI
1541,242,240,124,124,0,0,124,3 (3ct 0st),0.516,2008,2019,V Kohli ,INDIA
1542,92,92,124,120,4,120,0,5 (5ct 0st),1.347,1971,1984,RW Marsh ,AUS
1543,445,441,123,123,0,0,123,3 (3ct 0st),0.278,1989,2011,ST Jayasuriya ,SL
1544,227,225,120,120,0,0,120,4 (4ct 0st),0.5329999999999999,1987,2003,CL Hooper ,WI
1545,299,296,120,120,0,0,120,3 (3ct 0st),0.405,1990,2007,BC Lara ,WI
1546,85,83,117,105,12,105,0,4 (4ct 0st),1.409,2008,2017,L Ronchi ,AUS
1547,94,94,117,108,9,108,0,5 (5ct 0st),1.244,2012,2017,MS Wade ,AUS
1548,378,373,113,113,0,0,113,3 (3ct 0st),0.302,1991,2007,Inzamam-ul-Haq ,PAK
1549,325,324,111,111,0,0,111,3 (3ct 0st),0.342,1986,2002,SR Waugh ,AUS
1550,404,397,501,402,99,383,19,5 (4ct 1st),1.261,2000,2015,KC Sangakkara ,SL
1551,287,286,472,417,55,417,0,6 (6ct 0st),1.65,1996,2008,AC Gilchrist ,AUS
1552,350,345,444,321,123,321,0,6 (5ct 1st),1.286,2004,2019,MS Dhoni ,INDIA
1553,295,291,425,403,22,402,1,6 (6ct 0st),1.46,1998,2011,MV Boucher ,SA
1554,219,217,287,214,73,214,0,5 (5ct 0st),1.3219999999999998,1990,2004,Moin Khan ,PAK
1555,260,257,277,262,15,227,35,5 (5ct 0st),1.077,2002,2016,BB McCullum ,NZ
1556,168,168,233,194,39,194,0,4 (4ct 0st),1.386,1988,1997,IA Healy ,AUS
1557,216,215,225,181,44,179,2,5 (5ct 0st),1.046,2006,2019,Mushfiqur Rahim ,BDESH
1558,166,164,220,182,38,182,0,5 (5ct 0st),1.341,1992,2003,Rashid Latif ,PAK
1559,448,443,218,218,0,0,218,4 (4ct 0st),0.492,1998,2015,DPMD Jayawardene ,SL
1560,344,341,210,196,14,72,124,4 (4ct 0st),0.615,1996,2011,R Dravid ,INDIA
1561,189,188,207,132,75,131,1,5 (4ct 1st),1.101,1990,2004,RS Kaluwitharana ,SL
1562,169,168,204,183,21,183,0,4 (4ct 0st),1.214,1981,1991,PJL Dujon ,WI
1563,142,138,202,171,31,171,0,6 (6ct 0st),1.463,2012,2019,JC Buttler ,ENG
1564,147,145,189,160,29,160,0,6 (5ct 1st),1.3030000000000002,1996,2004,RD Jacobs ,WI
1565,157,154,188,157,31,156,1,5 (4ct 1st),1.22,2002,2017,Kamran Akmal ,PAK
1566,139,137,188,181,7,181,0,5 (5ct 0st),1.372,2005,2016,D Ramdin ,WI
1567,228,223,181,176,5,93,83,5 (5ct 0st),0.8109999999999999,2005,2018,AB de Villiers ,SA
1568,126,124,181,170,11,170,0,5 (5ct 0st),1.459,2001,2015,BJ Haddin ,AUS
1569,170,169,174,159,15,148,11,6 (6ct 0st),1.029,1989,2003,AJ Stewart ,ENG
1570,213,212,173,141,32,133,8,5 (5ct 0st),0.816,1992,2003,A Flower ,ZIM
1571,115,111,166,158,8,158,0,6 (5ct 1st),1.495,2013,2019,Q de Kock ,SA
1572,122,121,165,148,17,148,0,5 (5ct 0st),1.3630000000000002,1991,1998,DJ Richardson ,SA
1573,375,372,160,160,0,0,160,3 (3ct 0st),0.43,1995,2012,RT Ponting ,AUS
1574,334,332,156,156,0,0,156,4 (4ct 0st),0.469,1985,2000,M Azharuddin ,INDIA
1575,140,139,154,110,44,110,0,5 (4ct 1st),1.107,1994,2000,NR Mongia ,INDIA
1576,193,193,154,125,29,96,29,5 (5ct 0st),0.797,2004,2019,BRM Taylor ,ZIM
1577,150,150,147,114,33,112,2,4 (4ct 0st),0.98,2001,2012,T Taibu ,ZIM
1578,179,178,141,116,25,111,5,5 (3ct 2st),0.792,1992,2002,AC Parore ,NZ
1579,116,114,140,116,24,116,0,6 (6ct 0st),1.228,2007,2019,Sarfaraz Ahmed ,PAK
1580,463,456,140,140,0,0,140,4 (4ct 0st),0.307,1989,2012,SR Tendulkar ,INDIA
1581,228,224,137,137,0,0,137,4 (4ct 0st),0.611,2006,2019,LRPL Taylor ,NZ
1582,265,260,135,135,0,5,130,4 (4ct 0st),0.519,2000,2015,Younis Khan ,PAK
1583,280,276,133,133,0,0,133,4 (4ct 0st),0.481,1994,2007,SP Fleming ,NZ
1584,328,324,131,131,0,0,131,3 (3ct 0st),0.4039999999999999,1996,2014,JH Kallis ,SA
1585,350,347,130,130,0,0,130,3 (3ct 0st),0.374,1993,2011,M Muralitharan ,SL
1586,273,270,127,127,0,0,127,3 (3ct 0st),0.47,1979,1994,AR Border ,AUS
1587,398,392,127,127,0,0,127,2 (2ct 0st),0.3229999999999999,1996,2015,Shahid Afridi ,PAK
1588,126,126,126,91,35,91,0,5 (3ct 2st),1.0,1995,2006,Khaled Mashud ,BDESH
1589,330,325,124,123,1,5,118,3 (3ct 0st),0.381,1999,2016,TM Dilshan ,SL
1590,301,294,124,124,0,0,124,3 (3ct 0st),0.421,1999,2019,CH Gayle ,WI
1591,242,240,124,124,0,0,124,3 (3ct 0st),0.516,2008,2019,V Kohli ,INDIA
1592,92,92,124,120,4,120,0,5 (5ct 0st),1.347,1971,1984,RW Marsh ,AUS
1593,445,441,123,123,0,0,123,3 (3ct 0st),0.278,1989,2011,ST Jayasuriya ,SL
1594,227,225,120,120,0,0,120,4 (4ct 0st),0.5329999999999999,1987,2003,CL Hooper ,WI
1595,299,296,120,120,0,0,120,3 (3ct 0st),0.405,1990,2007,BC Lara ,WI
1596,85,83,117,105,12,105,0,4 (4ct 0st),1.409,2008,2017,L Ronchi ,AUS
1597,94,94,117,108,9,108,0,5 (5ct 0st),1.244,2012,2017,MS Wade ,AUS
1598,378,373,113,113,0,0,113,3 (3ct 0st),0.302,1991,2007,Inzamam-ul-Haq ,PAK
1599,325,324,111,111,0,0,111,3 (3ct 0st),0.342,1986,2002,SR Waugh ,AUS
1600,404,397,501,402,99,383,19,5 (4ct 1st),1.261,2000,2015,KC Sangakkara ,SL
1601,287,286,472,417,55,417,0,6 (6ct 0st),1.65,1996,2008,AC Gilchrist ,AUS
1602,350,345,444,321,123,321,0,6 (5ct 1st),1.286,2004,2019,MS Dhoni ,INDIA
1603,295,291,425,403,22,402,1,6 (6ct 0st),1.46,1998,2011,MV Boucher ,SA
1604,219,217,287,214,73,214,0,5 (5ct 0st),1.3219999999999998,1990,2004,Moin Khan ,PAK
1605,260,257,277,262,15,227,35,5 (5ct 0st),1.077,2002,2016,BB McCullum ,NZ
1606,168,168,233,194,39,194,0,4 (4ct 0st),1.386,1988,1997,IA Healy ,AUS
1607,216,215,225,181,44,179,2,5 (5ct 0st),1.046,2006,2019,Mushfiqur Rahim ,BDESH
1608,166,164,220,182,38,182,0,5 (5ct 0st),1.341,1992,2003,Rashid Latif ,PAK
1609,448,443,218,218,0,0,218,4 (4ct 0st),0.492,1998,2015,DPMD Jayawardene ,SL
1610,344,341,210,196,14,72,124,4 (4ct 0st),0.615,1996,2011,R Dravid ,INDIA
1611,189,188,207,132,75,131,1,5 (4ct 1st),1.101,1990,2004,RS Kaluwitharana ,SL
1612,169,168,204,183,21,183,0,4 (4ct 0st),1.214,1981,1991,PJL Dujon ,WI
1613,142,138,202,171,31,171,0,6 (6ct 0st),1.463,2012,2019,JC Buttler ,ENG
1614,147,145,189,160,29,160,0,6 (5ct 1st),1.3030000000000002,1996,2004,RD Jacobs ,WI
1615,157,154,188,157,31,156,1,5 (4ct 1st),1.22,2002,2017,Kamran Akmal ,PAK
1616,139,137,188,181,7,181,0,5 (5ct 0st),1.372,2005,2016,D Ramdin ,WI
1617,228,223,181,176,5,93,83,5 (5ct 0st),0.8109999999999999,2005,2018,AB de Villiers ,SA
1618,126,124,181,170,11,170,0,5 (5ct 0st),1.459,2001,2015,BJ Haddin ,AUS
1619,170,169,174,159,15,148,11,6 (6ct 0st),1.029,1989,2003,AJ Stewart ,ENG
1620,213,212,173,141,32,133,8,5 (5ct 0st),0.816,1992,2003,A Flower ,ZIM
1621,115,111,166,158,8,158,0,6 (5ct 1st),1.495,2013,2019,Q de Kock ,SA
1622,122,121,165,148,17,148,0,5 (5ct 0st),1.3630000000000002,1991,1998,DJ Richardson ,SA
1623,375,372,160,160,0,0,160,3 (3ct 0st),0.43,1995,2012,RT Ponting ,AUS
1624,334,332,156,156,0,0,156,4 (4ct 0st),0.469,1985,2000,M Azharuddin ,INDIA
1625,140,139,154,110,44,110,0,5 (4ct 1st),1.107,1994,2000,NR Mongia ,INDIA
1626,193,193,154,125,29,96,29,5 (5ct 0st),0.797,2004,2019,BRM Taylor ,ZIM
1627,150,150,147,114,33,112,2,4 (4ct 0st),0.98,2001,2012,T Taibu ,ZIM
1628,179,178,141,116,25,111,5,5 (3ct 2st),0.792,1992,2002,AC Parore ,NZ
1629,116,114,140,116,24,116,0,6 (6ct 0st),1.228,2007,2019,Sarfaraz Ahmed ,PAK
1630,463,456,140,140,0,0,140,4 (4ct 0st),0.307,1989,2012,SR Tendulkar ,INDIA
1631,228,224,137,137,0,0,137,4 (4ct 0st),0.611,2006,2019,LRPL Taylor ,NZ
1632,265,260,135,135,0,5,130,4 (4ct 0st),0.519,2000,2015,Younis Khan ,PAK
1633,280,276,133,133,0,0,133,4 (4ct 0st),0.481,1994,2007,SP Fleming ,NZ
1634,328,324,131,131,0,0,131,3 (3ct 0st),0.4039999999999999,1996,2014,JH Kallis ,SA
1635,350,347,130,130,0,0,130,3 (3ct 0st),0.374,1993,2011,M Muralitharan ,SL
1636,273,270,127,127,0,0,127,3 (3ct 0st),0.47,1979,1994,AR Border ,AUS
1637,398,392,127,127,0,0,127,2 (2ct 0st),0.3229999999999999,1996,2015,Shahid Afridi ,PAK
1638,126,126,126,91,35,91,0,5 (3ct 2st),1.0,1995,2006,Khaled Mashud ,BDESH
1639,330,325,124,123,1,5,118,3 (3ct 0st),0.381,1999,2016,TM Dilshan ,SL
1640,301,294,124,124,0,0,124,3 (3ct 0st),0.421,1999,2019,CH Gayle ,WI
1641,242,240,124,124,0,0,124,3 (3ct 0st),0.516,2008,2019,V Kohli ,INDIA
1642,92,92,124,120,4,120,0,5 (5ct 0st),1.347,1971,1984,RW Marsh ,AUS
1643,445,441,123,123,0,0,123,3 (3ct 0st),0.278,1989,2011,ST Jayasuriya ,SL
1644,227,225,120,120,0,0,120,4 (4ct 0st),0.5329999999999999,1987,2003,CL Hooper ,WI
1645,299,296,120,120,0,0,120,3 (3ct 0st),0.405,1990,2007,BC Lara ,WI
1646,85,83,117,105,12,105,0,4 (4ct 0st),1.409,2008,2017,L Ronchi ,AUS
1647,94,94,117,108,9,108,0,5 (5ct 0st),1.244,2012,2017,MS Wade ,AUS
1648,378,373,113,113,0,0,113,3 (3ct 0st),0.302,1991,2007,Inzamam-ul-Haq ,PAK
1649,325,324,111,111,0,0,111,3 (3ct 0st),0.342,1986,2002,SR Waugh ,AUS
1650,404,397,501,402,99,383,19,5 (4ct 1st),1.261,2000,2015,KC Sangakkara ,SL
1651,287,286,472,417,55,417,0,6 (6ct 0st),1.65,1996,2008,AC Gilchrist ,AUS
1652,350,345,444,321,123,321,0,6 (5ct 1st),1.286,2004,2019,MS Dhoni ,INDIA
1653,295,291,425,403,22,402,1,6 (6ct 0st),1.46,1998,2011,MV Boucher ,SA
1654,219,217,287,214,73,214,0,5 (5ct 0st),1.3219999999999998,1990,2004,Moin Khan ,PAK
1655,260,257,277,262,15,227,35,5 (5ct 0st),1.077,2002,2016,BB McCullum ,NZ
1656,168,168,233,194,39,194,0,4 (4ct 0st),1.386,1988,1997,IA Healy ,AUS
1657,216,215,225,181,44,179,2,5 (5ct 0st),1.046,2006,2019,Mushfiqur Rahim ,BDESH
1658,166,164,220,182,38,182,0,5 (5ct 0st),1.341,1992,2003,Rashid Latif ,PAK
1659,448,443,218,218,0,0,218,4 (4ct 0st),0.492,1998,2015,DPMD Jayawardene ,SL
1660,344,341,210,196,14,72,124,4 (4ct 0st),0.615,1996,2011,R Dravid ,INDIA
1661,189,188,207,132,75,131,1,5 (4ct 1st),1.101,1990,2004,RS Kaluwitharana ,SL
1662,169,168,204,183,21,183,0,4 (4ct 0st),1.214,1981,1991,PJL Dujon ,WI
1663,142,138,202,171,31,171,0,6 (6ct 0st),1.463,2012,2019,JC Buttler ,ENG
1664,147,145,189,160,29,160,0,6 (5ct 1st),1.3030000000000002,1996,2004,RD Jacobs ,WI
1665,157,154,188,157,31,156,1,5 (4ct 1st),1.22,2002,2017,Kamran Akmal ,PAK
1666,139,137,188,181,7,181,0,5 (5ct 0st),1.372,2005,2016,D Ramdin ,WI
1667,228,223,181,176,5,93,83,5 (5ct 0st),0.8109999999999999,2005,2018,AB de Villiers ,SA
1668,126,124,181,170,11,170,0,5 (5ct 0st),1.459,2001,2015,BJ Haddin ,AUS
1669,170,169,174,159,15,148,11,6 (6ct 0st),1.029,1989,2003,AJ Stewart ,ENG
1670,213,212,173,141,32,133,8,5 (5ct 0st),0.816,1992,2003,A Flower ,ZIM
1671,115,111,166,158,8,158,0,6 (5ct 1st),1.495,2013,2019,Q de Kock ,SA
1672,122,121,165,148,17,148,0,5 (5ct 0st),1.3630000000000002,1991,1998,DJ Richardson ,SA
1673,375,372,160,160,0,0,160,3 (3ct 0st),0.43,1995,2012,RT Ponting ,AUS
1674,334,332,156,156,0,0,156,4 (4ct 0st),0.469,1985,2000,M Azharuddin ,INDIA
1675,140,139,154,110,44,110,0,5 (4ct 1st),1.107,1994,2000,NR Mongia ,INDIA
1676,193,193,154,125,29,96,29,5 (5ct 0st),0.797,2004,2019,BRM Taylor ,ZIM
1677,150,150,147,114,33,112,2,4 (4ct 0st),0.98,2001,2012,T Taibu ,ZIM
1678,179,178,141,116,25,111,5,5 (3ct 2st),0.792,1992,2002,AC Parore ,NZ
1679,116,114,140,116,24,116,0,6 (6ct 0st),1.228,2007,2019,Sarfaraz Ahmed ,PAK
1680,463,456,140,140,0,0,140,4 (4ct 0st),0.307,1989,2012,SR Tendulkar ,INDIA
1681,228,224,137,137,0,0,137,4 (4ct 0st),0.611,2006,2019,LRPL Taylor ,NZ
1682,265,260,135,135,0,5,130,4 (4ct 0st),0.519,2000,2015,Younis Khan ,PAK
1683,280,276,133,133,0,0,133,4 (4ct 0st),0.481,1994,2007,SP Fleming ,NZ
1684,328,324,131,131,0,0,131,3 (3ct 0st),0.4039999999999999,1996,2014,JH Kallis ,SA
1685,350,347,130,130,0,0,130,3 (3ct 0st),0.374,1993,2011,M Muralitharan ,SL
1686,273,270,127,127,0,0,127,3 (3ct 0st),0.47,1979,1994,AR Border ,AUS
1687,398,392,127,127,0,0,127,2 (2ct 0st),0.3229999999999999,1996,2015,Shahid Afridi ,PAK
1688,126,126,126,91,35,91,0,5 (3ct 2st),1.0,1995,2006,Khaled Mashud ,BDESH
1689,330,325,124,123,1,5,118,3 (3ct 0st),0.381,1999,2016,TM Dilshan ,SL
1690,301,294,124,124,0,0,124,3 (3ct 0st),0.421,1999,2019,CH Gayle ,WI
1691,242,240,124,124,0,0,124,3 (3ct 0st),0.516,2008,2019,V Kohli ,INDIA
1692,92,92,124,120,4,120,0,5 (5ct 0st),1.347,1971,1984,RW Marsh ,AUS
1693,445,441,123,123,0,0,123,3 (3ct 0st),0.278,1989,2011,ST Jayasuriya ,SL
1694,227,225,120,120,0,0,120,4 (4ct 0st),0.5329999999999999,1987,2003,CL Hooper ,WI
1695,299,296,120,120,0,0,120,3 (3ct 0st),0.405,1990,2007,BC Lara ,WI
1696,85,83,117,105,12,105,0,4 (4ct 0st),1.409,2008,2017,L Ronchi ,AUS
1697,94,94,117,108,9,108,0,5 (5ct 0st),1.244,2012,2017,MS Wade ,AUS
1698,378,373,113,113,0,0,113,3 (3ct 0st),0.302,1991,2007,Inzamam-ul-Haq ,PAK
1699,325,324,111,111,0,0,111,3 (3ct 0st),0.342,1986,2002,SR Waugh ,AUS
1700,404,397,501,402,99,383,19,5 (4ct 1st),1.261,2000,2015,KC Sangakkara ,SL
1701,287,286,472,417,55,417,0,6 (6ct 0st),1.65,1996,2008,AC Gilchrist ,AUS
1702,350,345,444,321,123,321,0,6 (5ct 1st),1.286,2004,2019,MS Dhoni ,INDIA
1703,295,291,425,403,22,402,1,6 (6ct 0st),1.46,1998,2011,MV Boucher ,SA
1704,219,217,287,214,73,214,0,5 (5ct 0st),1.3219999999999998,1990,2004,Moin Khan ,PAK
1705,260,257,277,262,15,227,35,5 (5ct 0st),1.077,2002,2016,BB McCullum ,NZ
1706,168,168,233,194,39,194,0,4 (4ct 0st),1.386,1988,1997,IA Healy ,AUS
1707,216,215,225,181,44,179,2,5 (5ct 0st),1.046,2006,2019,Mushfiqur Rahim ,BDESH
1708,166,164,220,182,38,182,0,5 (5ct 0st),1.341,1992,2003,Rashid Latif ,PAK
1709,448,443,218,218,0,0,218,4 (4ct 0st),0.492,1998,2015,DPMD Jayawardene ,SL
1710,344,341,210,196,14,72,124,4 (4ct 0st),0.615,1996,2011,R Dravid ,INDIA
1711,189,188,207,132,75,131,1,5 (4ct 1st),1.101,1990,2004,RS Kaluwitharana ,SL
1712,169,168,204,183,21,183,0,4 (4ct 0st),1.214,1981,1991,PJL Dujon ,WI
1713,142,138,202,171,31,171,0,6 (6ct 0st),1.463,2012,2019,JC Buttler ,ENG
1714,147,145,189,160,29,160,0,6 (5ct 1st),1.3030000000000002,1996,2004,RD Jacobs ,WI
1715,157,154,188,157,31,156,1,5 (4ct 1st),1.22,2002,2017,Kamran Akmal ,PAK
1716,139,137,188,181,7,181,0,5 (5ct 0st),1.372,2005,2016,D Ramdin ,WI
1717,228,223,181,176,5,93,83,5 (5ct 0st),0.8109999999999999,2005,2018,AB de Villiers ,SA
1718,126,124,181,170,11,170,0,5 (5ct 0st),1.459,2001,2015,BJ Haddin ,AUS
1719,170,169,174,159,15,148,11,6 (6ct 0st),1.029,1989,2003,AJ Stewart ,ENG
1720,213,212,173,141,32,133,8,5 (5ct 0st),0.816,1992,2003,A Flower ,ZIM
1721,115,111,166,158,8,158,0,6 (5ct 1st),1.495,2013,2019,Q de Kock ,SA
1722,122,121,165,148,17,148,0,5 (5ct 0st),1.3630000000000002,1991,1998,DJ Richardson ,SA
1723,375,372,160,160,0,0,160,3 (3ct 0st),0.43,1995,2012,RT Ponting ,AUS
1724,334,332,156,156,0,0,156,4 (4ct 0st),0.469,1985,2000,M Azharuddin ,INDIA
1725,140,139,154,110,44,110,0,5 (4ct 1st),1.107,1994,2000,NR Mongia ,INDIA
1726,193,193,154,125,29,96,29,5 (5ct 0st),0.797,2004,2019,BRM Taylor ,ZIM
1727,150,150,147,114,33,112,2,4 (4ct 0st),0.98,2001,2012,T Taibu ,ZIM
1728,179,178,141,116,25,111,5,5 (3ct 2st),0.792,1992,2002,AC Parore ,NZ
1729,116,114,140,116,24,116,0,6 (6ct 0st),1.228,2007,2019,Sarfaraz Ahmed ,PAK
1730,463,456,140,140,0,0,140,4 (4ct 0st),0.307,1989,2012,SR Tendulkar ,INDIA
1731,228,224,137,137,0,0,137,4 (4ct 0st),0.611,2006,2019,LRPL Taylor ,NZ
1732,265,260,135,135,0,5,130,4 (4ct 0st),0.519,2000,2015,Younis Khan ,PAK
1733,280,276,133,133,0,0,133,4 (4ct 0st),0.481,1994,2007,SP Fleming ,NZ
1734,328,324,131,131,0,0,131,3 (3ct 0st),0.4039999999999999,1996,2014,JH Kallis ,SA
1735,350,347,130,130,0,0,130,3 (3ct 0st),0.374,1993,2011,M Muralitharan ,SL
1736,273,270,127,127,0,0,127,3 (3ct 0st),0.47,1979,1994,AR Border ,AUS
1737,398,392,127,127,0,0,127,2 (2ct 0st),0.3229999999999999,1996,2015,Shahid Afridi ,PAK
1738,126,126,126,91,35,91,0,5 (3ct 2st),1.0,1995,2006,Khaled Mashud ,BDESH
1739,330,325,124,123,1,5,118,3 (3ct 0st),0.381,1999,2016,TM Dilshan ,SL
1740,301,294,124,124,0,0,124,3 (3ct 0st),0.421,1999,2019,CH Gayle ,WI
1741,242,240,124,124,0,0,124,3 (3ct 0st),0.516,2008,2019,V Kohli ,INDIA
1742,92,92,124,120,4,120,0,5 (5ct 0st),1.347,1971,1984,RW Marsh ,AUS
1743,445,441,123,123,0,0,123,3 (3ct 0st),0.278,1989,2011,ST Jayasuriya ,SL
1744,227,225,120,120,0,0,120,4 (4ct 0st),0.5329999999999999,1987,2003,CL Hooper ,WI
1745,299,296,120,120,0,0,120,3 (3ct 0st),0.405,1990,2007,BC Lara ,WI
1746,85,83,117,105,12,105,0,4 (4ct 0st),1.409,2008,2017,L Ronchi ,AUS
1747,94,94,117,108,9,108,0,5 (5ct 0st),1.244,2012,2017,MS Wade ,AUS
1748,378,373,113,113,0,0,113,3 (3ct 0st),0.302,1991,2007,Inzamam-ul-Haq ,PAK
1749,325,324,111,111,0,0,111,3 (3ct 0st),0.342,1986,2002,SR Waugh ,AUS
1750,404,397,501,402,99,383,19,5 (4ct 1st),1.261,2000,2015,KC Sangakkara ,SL
1751,287,286,472,417,55,417,0,6 (6ct 0st),1.65,1996,2008,AC Gilchrist ,AUS
1752,350,345,444,321,123,321,0,6 (5ct 1st),1.286,2004,2019,MS Dhoni ,INDIA
1753,295,291,425,403,22,402,1,6 (6ct 0st),1.46,1998,2011,MV Boucher ,SA
1754,219,217,287,214,73,214,0,5 (5ct 0st),1.3219999999999998,1990,2004,Moin Khan ,PAK
1755,260,257,277,262,15,227,35,5 (5ct 0st),1.077,2002,2016,BB McCullum ,NZ
1756,168,168,233,194,39,194,0,4 (4ct 0st),1.386,1988,1997,IA Healy ,AUS
1757,216,215,225,181,44,179,2,5 (5ct 0st),1.046,2006,2019,Mushfiqur Rahim ,BDESH
1758,166,164,220,182,38,182,0,5 (5ct 0st),1.341,1992,2003,Rashid Latif ,PAK
1759,448,443,218,218,0,0,218,4 (4ct 0st),0.492,1998,2015,DPMD Jayawardene ,SL
1760,344,341,210,196,14,72,124,4 (4ct 0st),0.615,1996,2011,R Dravid ,INDIA
1761,189,188,207,132,75,131,1,5 (4ct 1st),1.101,1990,2004,RS Kaluwitharana ,SL
1762,169,168,204,183,21,183,0,4 (4ct 0st),1.214,1981,1991,PJL Dujon ,WI
1763,142,138,202,171,31,171,0,6 (6ct 0st),1.463,2012,2019,JC Buttler ,ENG
1764,147,145,189,160,29,160,0,6 (5ct 1st),1.3030000000000002,1996,2004,RD Jacobs ,WI
1765,157,154,188,157,31,156,1,5 (4ct 1st),1.22,2002,2017,Kamran Akmal ,PAK
1766,139,137,188,181,7,181,0,5 (5ct 0st),1.372,2005,2016,D Ramdin ,WI
1767,228,223,181,176,5,93,83,5 (5ct 0st),0.8109999999999999,2005,2018,AB de Villiers ,SA
1768,126,124,181,170,11,170,0,5 (5ct 0st),1.459,2001,2015,BJ Haddin ,AUS
1769,170,169,174,159,15,148,11,6 (6ct 0st),1.029,1989,2003,AJ Stewart ,ENG
1770,213,212,173,141,32,133,8,5 (5ct 0st),0.816,1992,2003,A Flower ,ZIM
1771,115,111,166,158,8,158,0,6 (5ct 1st),1.495,2013,2019,Q de Kock ,SA
1772,122,121,165,148,17,148,0,5 (5ct 0st),1.3630000000000002,1991,1998,DJ Richardson ,SA
1773,375,372,160,160,0,0,160,3 (3ct 0st),0.43,1995,2012,RT Ponting ,AUS
1774,334,332,156,156,0,0,156,4 (4ct 0st),0.469,1985,2000,M Azharuddin ,INDIA
1775,140,139,154,110,44,110,0,5 (4ct 1st),1.107,1994,2000,NR Mongia ,INDIA
1776,193,193,154,125,29,96,29,5 (5ct 0st),0.797,2004,2019,BRM Taylor ,ZIM
1777,150,150,147,114,33,112,2,4 (4ct 0st),0.98,2001,2012,T Taibu ,ZIM
1778,179,178,141,116,25,111,5,5 (3ct 2st),0.792,1992,2002,AC Parore ,NZ
1779,116,114,140,116,24,116,0,6 (6ct 0st),1.228,2007,2019,Sarfaraz Ahmed ,PAK
1780,463,456,140,140,0,0,140,4 (4ct 0st),0.307,1989,2012,SR Tendulkar ,INDIA
1781,228,224,137,137,0,0,137,4 (4ct 0st),0.611,2006,2019,LRPL Taylor ,NZ
1782,265,260,135,135,0,5,130,4 (4ct 0st),0.519,2000,2015,Younis Khan ,PAK
1783,280,276,133,133,0,0,133,4 (4ct 0st),0.481,1994,2007,SP Fleming ,NZ
1784,328,324,131,131,0,0,131,3 (3ct 0st),0.4039999999999999,1996,2014,JH Kallis ,SA
1785,350,347,130,130,0,0,130,3 (3ct 0st),0.374,1993,2011,M Muralitharan ,SL
1786,273,270,127,127,0,0,127,3 (3ct 0st),0.47,1979,1994,AR Border ,AUS
1787,398,392,127,127,0,0,127,2 (2ct 0st),0.3229999999999999,1996,2015,Shahid Afridi ,PAK
1788,126,126,126,91,35,91,0,5 (3ct 2st),1.0,1995,2006,Khaled Mashud ,BDESH
1789,330,325,124,123,1,5,118,3 (3ct 0st),0.381,1999,2016,TM Dilshan ,SL
1790,301,294,124,124,0,0,124,3 (3ct 0st),0.421,1999,2019,CH Gayle ,WI
1791,242,240,124,124,0,0,124,3 (3ct 0st),0.516,2008,2019,V Kohli ,INDIA
1792,92,92,124,120,4,120,0,5 (5ct 0st),1.347,1971,1984,RW Marsh ,AUS
1793,445,441,123,123,0,0,123,3 (3ct 0st),0.278,1989,2011,ST Jayasuriya ,SL
1794,227,225,120,120,0,0,120,4 (4ct 0st),0.5329999999999999,1987,2003,CL Hooper ,WI
1795,299,296,120,120,0,0,120,3 (3ct 0st),0.405,1990,2007,BC Lara ,WI
1796,85,83,117,105,12,105,0,4 (4ct 0st),1.409,2008,2017,L Ronchi ,AUS
1797,94,94,117,108,9,108,0,5 (5ct 0st),1.244,2012,2017,MS Wade ,AUS
1798,378,373,113,113,0,0,113,3 (3ct 0st),0.302,1991,2007,Inzamam-ul-Haq ,PAK
1799,325,324,111,111,0,0,111,3 (3ct 0st),0.342,1986,2002,SR Waugh ,AUS
1800,404,397,501,402,99,383,19,5 (4ct 1st),1.261,2000,2015,KC Sangakkara ,SL
1801,287,286,472,417,55,417,0,6 (6ct 0st),1.65,1996,2008,AC Gilchrist ,AUS
1802,350,345,444,321,123,321,0,6 (5ct 1st),1.286,2004,2019,MS Dhoni ,INDIA
1803,295,291,425,403,22,402,1,6 (6ct 0st),1.46,1998,2011,MV Boucher ,SA
1804,219,217,287,214,73,214,0,5 (5ct 0st),1.3219999999999998,1990,2004,Moin Khan ,PAK
1805,260,257,277,262,15,227,35,5 (5ct 0st),1.077,2002,2016,BB McCullum ,NZ
1806,168,168,233,194,39,194,0,4 (4ct 0st),1.386,1988,1997,IA Healy ,AUS
1807,216,215,225,181,44,179,2,5 (5ct 0st),1.046,2006,2019,Mushfiqur Rahim ,BDESH
1808,166,164,220,182,38,182,0,5 (5ct 0st),1.341,1992,2003,Rashid Latif ,PAK
1809,448,443,218,218,0,0,218,4 (4ct 0st),0.492,1998,2015,DPMD Jayawardene ,SL
1810,344,341,210,196,14,72,124,4 (4ct 0st),0.615,1996,2011,R Dravid ,INDIA
1811,189,188,207,132,75,131,1,5 (4ct 1st),1.101,1990,2004,RS Kaluwitharana ,SL
1812,169,168,204,183,21,183,0,4 (4ct 0st),1.214,1981,1991,PJL Dujon ,WI
1813,142,138,202,171,31,171,0,6 (6ct 0st),1.463,2012,2019,JC Buttler ,ENG
1814,147,145,189,160,29,160,0,6 (5ct 1st),1.3030000000000002,1996,2004,RD Jacobs ,WI
1815,157,154,188,157,31,156,1,5 (4ct 1st),1.22,2002,2017,Kamran Akmal ,PAK
1816,139,137,188,181,7,181,0,5 (5ct 0st),1.372,2005,2016,D Ramdin ,WI
1817,228,223,181,176,5,93,83,5 (5ct 0st),0.8109999999999999,2005,2018,AB de Villiers ,SA
1818,126,124,181,170,11,170,0,5 (5ct 0st),1.459,2001,2015,BJ Haddin ,AUS
1819,170,169,174,159,15,148,11,6 (6ct 0st),1.029,1989,2003,AJ Stewart ,ENG
1820,213,212,173,141,32,133,8,5 (5ct 0st),0.816,1992,2003,A Flower ,ZIM
1821,115,111,166,158,8,158,0,6 (5ct 1st),1.495,2013,2019,Q de Kock ,SA
1822,122,121,165,148,17,148,0,5 (5ct 0st),1.3630000000000002,1991,1998,DJ Richardson ,SA
1823,375,372,160,160,0,0,160,3 (3ct 0st),0.43,1995,2012,RT Ponting ,AUS
1824,334,332,156,156,0,0,156,4 (4ct 0st),0.469,1985,2000,M Azharuddin ,INDIA
1825,140,139,154,110,44,110,0,5 (4ct 1st),1.107,1994,2000,NR Mongia ,INDIA
1826,193,193,154,125,29,96,29,5 (5ct 0st),0.797,2004,2019,BRM Taylor ,ZIM
1827,150,150,147,114,33,112,2,4 (4ct 0st),0.98,2001,2012,T Taibu ,ZIM
1828,179,178,141,116,25,111,5,5 (3ct 2st),0.792,1992,2002,AC Parore ,NZ
1829,116,114,140,116,24,116,0,6 (6ct 0st),1.228,2007,2019,Sarfaraz Ahmed ,PAK
1830,463,456,140,140,0,0,140,4 (4ct 0st),0.307,1989,2012,SR Tendulkar ,INDIA
1831,228,224,137,137,0,0,137,4 (4ct 0st),0.611,2006,2019,LRPL Taylor ,NZ
1832,265,260,135,135,0,5,130,4 (4ct 0st),0.519,2000,2015,Younis Khan ,PAK
1833,280,276,133,133,0,0,133,4 (4ct 0st),0.481,1994,2007,SP Fleming ,NZ
1834,328,324,131,131,0,0,131,3 (3ct 0st),0.4039999999999999,1996,2014,JH Kallis ,SA
1835,350,347,130,130,0,0,130,3 (3ct 0st),0.374,1993,2011,M Muralitharan ,SL
1836,273,270,127,127,0,0,127,3 (3ct 0st),0.47,1979,1994,AR Border ,AUS
1837,398,392,127,127,0,0,127,2 (2ct 0st),0.3229999999999999,1996,2015,Shahid Afridi ,PAK
1838,126,126,126,91,35,91,0,5 (3ct 2st),1.0,1995,2006,Khaled Mashud ,BDESH
1839,330,325,124,123,1,5,118,3 (3ct 0st),0.381,1999,2016,TM Dilshan ,SL
1840,301,294,124,124,0,0,124,3 (3ct 0st),0.421,1999,2019,CH Gayle ,WI
1841,242,240,124,124,0,0,124,3 (3ct 0st),0.516,2008,2019,V Kohli ,INDIA
1842,92,92,124,120,4,120,0,5 (5ct 0st),1.347,1971,1984,RW Marsh ,AUS
1843,445,441,123,123,0,0,123,3 (3ct 0st),0.278,1989,2011,ST Jayasuriya ,SL
1844,227,225,120,120,0,0,120,4 (4ct 0st),0.5329999999999999,1987,2003,CL Hooper ,WI
1845,299,296,120,120,0,0,120,3 (3ct 0st),0.405,1990,2007,BC Lara ,WI
1846,85,83,117,105,12,105,0,4 (4ct 0st),1.409,2008,2017,L Ronchi ,AUS
1847,94,94,117,108,9,108,0,5 (5ct 0st),1.244,2012,2017,MS Wade ,AUS
1848,378,373,113,113,0,0,113,3 (3ct 0st),0.302,1991,2007,Inzamam-ul-Haq ,PAK
1849,325,324,111,111,0,0,111,3 (3ct 0st),0.342,1986,2002,SR Waugh ,AUS
1850,404,397,501,402,99,383,19,5 (4ct 1st),1.261,2000,2015,KC Sangakkara ,SL
1851,287,286,472,417,55,417,0,6 (6ct 0st),1.65,1996,2008,AC Gilchrist ,AUS
1852,350,345,444,321,123,321,0,6 (5ct 1st),1.286,2004,2019,MS Dhoni ,INDIA
1853,295,291,425,403,22,402,1,6 (6ct 0st),1.46,1998,2011,MV Boucher ,SA
1854,219,217,287,214,73,214,0,5 (5ct 0st),1.3219999999999998,1990,2004,Moin Khan ,PAK
1855,260,257,277,262,15,227,35,5 (5ct 0st),1.077,2002,2016,BB McCullum ,NZ
1856,168,168,233,194,39,194,0,4 (4ct 0st),1.386,1988,1997,IA Healy ,AUS
1857,216,215,225,181,44,179,2,5 (5ct 0st),1.046,2006,2019,Mushfiqur Rahim ,BDESH
1858,166,164,220,182,38,182,0,5 (5ct 0st),1.341,1992,2003,Rashid Latif ,PAK
1859,448,443,218,218,0,0,218,4 (4ct 0st),0.492,1998,2015,DPMD Jayawardene ,SL
1860,344,341,210,196,14,72,124,4 (4ct 0st),0.615,1996,2011,R Dravid ,INDIA
1861,189,188,207,132,75,131,1,5 (4ct 1st),1.101,1990,2004,RS Kaluwitharana ,SL
1862,169,168,204,183,21,183,0,4 (4ct 0st),1.214,1981,1991,PJL Dujon ,WI
1863,142,138,202,171,31,171,0,6 (6ct 0st),1.463,2012,2019,JC Buttler ,ENG
1864,147,145,189,160,29,160,0,6 (5ct 1st),1.3030000000000002,1996,2004,RD Jacobs ,WI
1865,157,154,188,157,31,156,1,5 (4ct 1st),1.22,2002,2017,Kamran Akmal ,PAK
1866,139,137,188,181,7,181,0,5 (5ct 0st),1.372,2005,2016,D Ramdin ,WI
1867,228,223,181,176,5,93,83,5 (5ct 0st),0.8109999999999999,2005,2018,AB de Villiers ,SA
1868,126,124,181,170,11,170,0,5 (5ct 0st),1.459,2001,2015,BJ Haddin ,AUS
1869,170,169,174,159,15,148,11,6 (6ct 0st),1.029,1989,2003,AJ Stewart ,ENG
1870,213,212,173,141,32,133,8,5 (5ct 0st),0.816,1992,2003,A Flower ,ZIM
1871,115,111,166,158,8,158,0,6 (5ct 1st),1.495,2013,2019,Q de Kock ,SA
1872,122,121,165,148,17,148,0,5 (5ct 0st),1.3630000000000002,1991,1998,DJ Richardson ,SA
1873,375,372,160,160,0,0,160,3 (3ct 0st),0.43,1995,2012,RT Ponting ,AUS
1874,334,332,156,156,0,0,156,4 (4ct 0st),0.469,1985,2000,M Azharuddin ,INDIA
1875,140,139,154,110,44,110,0,5 (4ct 1st),1.107,1994,2000,NR Mongia ,INDIA
1876,193,193,154,125,29,96,29,5 (5ct 0st),0.797,2004,2019,BRM Taylor ,ZIM
1877,150,150,147,114,33,112,2,4 (4ct 0st),0.98,2001,2012,T Taibu ,ZIM
1878,179,178,141,116,25,111,5,5 (3ct 2st),0.792,1992,2002,AC Parore ,NZ
1879,116,114,140,116,24,116,0,6 (6ct 0st),1.228,2007,2019,Sarfaraz Ahmed ,PAK
1880,463,456,140,140,0,0,140,4 (4ct 0st),0.307,1989,2012,SR Tendulkar ,INDIA
1881,228,224,137,137,0,0,137,4 (4ct 0st),0.611,2006,2019,LRPL Taylor ,NZ
1882,265,260,135,135,0,5,130,4 (4ct 0st),0.519,2000,2015,Younis Khan ,PAK
1883,280,276,133,133,0,0,133,4 (4ct 0st),0.481,1994,2007,SP Fleming ,NZ
1884,328,324,131,131,0,0,131,3 (3ct 0st),0.4039999999999999,1996,2014,JH Kallis ,SA
1885,350,347,130,130,0,0,130,3 (3ct 0st),0.374,1993,2011,M Muralitharan ,SL
1886,273,270,127,127,0,0,127,3 (3ct 0st),0.47,1979,1994,AR Border ,AUS
1887,398,392,127,127,0,0,127,2 (2ct 0st),0.3229999999999999,1996,2015,Shahid Afridi ,PAK
1888,126,126,126,91,35,91,0,5 (3ct 2st),1.0,1995,2006,Khaled Mashud ,BDESH
1889,330,325,124,123,1,5,118,3 (3ct 0st),0.381,1999,2016,TM Dilshan ,SL
1890,301,294,124,124,0,0,124,3 (3ct 0st),0.421,1999,2019,CH Gayle ,WI
1891,242,240,124,124,0,0,124,3 (3ct 0st),0.516,2008,2019,V Kohli ,INDIA
1892,92,92,124,120,4,120,0,5 (5ct 0st),1.347,1971,1984,RW Marsh ,AUS
1893,445,441,123,123,0,0,123,3 (3ct 0st),0.278,1989,2011,ST Jayasuriya ,SL
1894,227,225,120,120,0,0,120,4 (4ct 0st),0.5329999999999999,1987,2003,CL Hooper ,WI
1895,299,296,120,120,0,0,120,3 (3ct 0st),0.405,1990,2007,BC Lara ,WI
1896,85,83,117,105,12,105,0,4 (4ct 0st),1.409,2008,2017,L Ronchi ,AUS
1897,94,94,117,108,9,108,0,5 (5ct 0st),1.244,2012,2017,MS Wade ,AUS
1898,378,373,113,113,0,0,113,3 (3ct 0st),0.302,1991,2007,Inzamam-ul-Haq ,PAK
1899,325,324,111,111,0,0,111,3 (3ct 0st),0.342,1986,2002,SR Waugh ,AUS
1900,404,397,501,402,99,383,19,5 (4ct 1st),1.261,2000,2015,KC Sangakkara ,SL
1901,287,286,472,417,55,417,0,6 (6ct 0st),1.65,1996,2008,AC Gilchrist ,AUS
1902,350,345,444,321,123,321,0,6 (5ct 1st),1.286,2004,2019,MS Dhoni ,INDIA
1903,295,291,425,403,22,402,1,6 (6ct 0st),1.46,1998,2011,MV Boucher ,SA
1904,219,217,287,214,73,214,0,5 (5ct 0st),1.3219999999999998,1990,2004,Moin Khan ,PAK
1905,260,257,277,262,15,227,35,5 (5ct 0st),1.077,2002,2016,BB McCullum ,NZ
1906,168,168,233,194,39,194,0,4 (4ct 0st),1.386,1988,1997,IA Healy ,AUS
1907,216,215,225,181,44,179,2,5 (5ct 0st),1.046,2006,2019,Mushfiqur Rahim ,BDESH
1908,166,164,220,182,38,182,0,5 (5ct 0st),1.341,1992,2003,Rashid Latif ,PAK
1909,448,443,218,218,0,0,218,4 (4ct 0st),0.492,1998,2015,DPMD Jayawardene ,SL
1910,344,341,210,196,14,72,124,4 (4ct 0st),0.615,1996,2011,R Dravid ,INDIA
1911,189,188,207,132,75,131,1,5 (4ct 1st),1.101,1990,2004,RS Kaluwitharana ,SL
1912,169,168,204,183,21,183,0,4 (4ct 0st),1.214,1981,1991,PJL Dujon ,WI
1913,142,138,202,171,31,171,0,6 (6ct 0st),1.463,2012,2019,JC Buttler ,ENG
1914,147,145,189,160,29,160,0,6 (5ct 1st),1.3030000000000002,1996,2004,RD Jacobs ,WI
1915,157,154,188,157,31,156,1,5 (4ct 1st),1.22,2002,2017,Kamran Akmal ,PAK
1916,139,137,188,181,7,181,0,5 (5ct 0st),1.372,2005,2016,D Ramdin ,WI
1917,228,223,181,176,5,93,83,5 (5ct 0st),0.8109999999999999,2005,2018,AB de Villiers ,SA
1918,126,124,181,170,11,170,0,5 (5ct 0st),1.459,2001,2015,BJ Haddin ,AUS
1919,170,169,174,159,15,148,11,6 (6ct 0st),1.029,1989,2003,AJ Stewart ,ENG
1920,213,212,173,141,32,133,8,5 (5ct 0st),0.816,1992,2003,A Flower ,ZIM
1921,115,111,166,158,8,158,0,6 (5ct 1st),1.495,2013,2019,Q de Kock ,SA
1922,122,121,165,148,17,148,0,5 (5ct 0st),1.3630000000000002,1991,1998,DJ Richardson ,SA
1923,375,372,160,160,0,0,160,3 (3ct 0st),0.43,1995,2012,RT Ponting ,AUS
1924,334,332,156,156,0,0,156,4 (4ct 0st),0.469,1985,2000,M Azharuddin ,INDIA
1925,140,139,154,110,44,110,0,5 (4ct 1st),1.107,1994,2000,NR Mongia ,INDIA
1926,193,193,154,125,29,96,29,5 (5ct 0st),0.797,2004,2019,BRM Taylor ,ZIM
1927,150,150,147,114,33,112,2,4 (4ct 0st),0.98,2001,2012,T Taibu ,ZIM
1928,179,178,141,116,25,111,5,5 (3ct 2st),0.792,1992,2002,AC Parore ,NZ
1929,116,114,140,116,24,116,0,6 (6ct 0st),1.228,2007,2019,Sarfaraz Ahmed ,PAK
1930,463,456,140,140,0,0,140,4 (4ct 0st),0.307,1989,2012,SR Tendulkar ,INDIA
1931,228,224,137,137,0,0,137,4 (4ct 0st),0.611,2006,2019,LRPL Taylor ,NZ
1932,265,260,135,135,0,5,130,4 (4ct 0st),0.519,2000,2015,Younis Khan ,PAK
1933,280,276,133,133,0,0,133,4 (4ct 0st),0.481,1994,2007,SP Fleming ,NZ
1934,328,324,131,131,0,0,131,3 (3ct 0st),0.4039999999999999,1996,2014,JH Kallis ,SA
1935,350,347,130,130,0,0,130,3 (3ct 0st),0.374,1993,2011,M Muralitharan ,SL
1936,273,270,127,127,0,0,127,3 (3ct 0st),0.47,1979,1994,AR Border ,AUS
1937,398,392,127,127,0,0,127,2 (2ct 0st),0.3229999999999999,1996,2015,Shahid Afridi ,PAK
1938,126,126,126,91,35,91,0,5 (3ct 2st),1.0,1995,2006,Khaled Mashud ,BDESH
1939,330,325,124,123,1,5,118,3 (3ct 0st),0.381,1999,2016,TM Dilshan ,SL
1940,301,294,124,124,0,0,124,3 (3ct 0st),0.421,1999,2019,CH Gayle ,WI
1941,242,240,124,124,0,0,124,3 (3ct 0st),0.516,2008,2019,V Kohli ,INDIA
1942,92,92,124,120,4,120,0,5 (5ct 0st),1.347,1971,1984,RW Marsh ,AUS
1943,445,441,123,123,0,0,123,3 (3ct 0st),0.278,1989,2011,ST Jayasuriya ,SL
1944,227,225,120,120,0,0,120,4 (4ct 0st),0.5329999999999999,1987,2003,CL Hooper ,WI
1945,299,296,120,120,0,0,120,3 (3ct 0st),0.405,1990,2007,BC Lara ,WI
1946,85,83,117,105,12,105,0,4 (4ct 0st),1.409,2008,2017,L Ronchi ,AUS
1947,94,94,117,108,9,108,0,5 (5ct 0st),1.244,2012,2017,MS Wade ,AUS
1948,378,373,113,113,0,0,113,3 (3ct 0st),0.302,1991,2007,Inzamam-ul-Haq ,PAK
1949,325,324,111,111,0,0,111,3 (3ct 0st),0.342,1986,2002,SR Waugh ,AUS
1950,404,397,501,402,99,383,19,5 (4ct 1st),1.261,2000,2015,KC Sangakkara ,SL
1951,287,286,472,417,55,417,0,6 (6ct 0st),1.65,1996,2008,AC Gilchrist ,AUS
1952,350,345,444,321,123,321,0,6 (5ct 1st),1.286,2004,2019,MS Dhoni ,INDIA
1953,295,291,425,403,22,402,1,6 (6ct 0st),1.46,1998,2011,MV Boucher ,SA
1954,219,217,287,214,73,214,0,5 (5ct 0st),1.3219999999999998,1990,2004,Moin Khan ,PAK
1955,260,257,277,262,15,227,35,5 (5ct 0st),1.077,2002,2016,BB McCullum ,NZ
1956,168,168,233,194,39,194,0,4 (4ct 0st),1.386,1988,1997,IA Healy ,AUS
1957,216,215,225,181,44,179,2,5 (5ct 0st),1.046,2006,2019,Mushfiqur Rahim ,BDESH
1958,166,164,220,182,38,182,0,5 (5ct 0st),1.341,1992,2003,Rashid Latif ,PAK
1959,448,443,218,218,0,0,218,4 (4ct 0st),0.492,1998,2015,DPMD Jayawardene ,SL
1960,344,341,210,196,14,72,124,4 (4ct 0st),0.615,1996,2011,R Dravid ,INDIA
1961,189,188,207,132,75,131,1,5 (4ct 1st),1.101,1990,2004,RS Kaluwitharana ,SL
1962,169,168,204,183,21,183,0,4 (4ct 0st),1.214,1981,1991,PJL Dujon ,WI
1963,142,138,202,171,31,171,0,6 (6ct 0st),1.463,2012,2019,JC Buttler ,ENG
1964,147,145,189,160,29,160,0,6 (5ct 1st),1.3030000000000002,1996,2004,RD Jacobs ,WI
1965,157,154,188,157,31,156,1,5 (4ct 1st),1.22,2002,2017,Kamran Akmal ,PAK
1966,139,137,188,181,7,181,0,5 (5ct 0st),1.372,2005,2016,D Ramdin ,WI
1967,228,223,181,176,5,93,83,5 (5ct 0st),0.8109999999999999,2005,2018,AB de Villiers ,SA
1968,126,124,181,170,11,170,0,5 (5ct 0st),1.459,2001,2015,BJ Haddin ,AUS
1969,170,169,174,159,15,148,11,6 (6ct 0st),1.029,1989,2003,AJ Stewart ,ENG
1970,213,212,173,141,32,133,8,5 (5ct 0st),0.816,1992,2003,A Flower ,ZIM
1971,115,111,166,158,8,158,0,6 (5ct 1st),1.495,2013,2019,Q de Kock ,SA
1972,122,121,165,148,17,148,0,5 (5ct 0st),1.3630000000000002,1991,1998,DJ Richardson ,SA
1973,375,372,160,160,0,0,160,3 (3ct 0st),0.43,1995,2012,RT Ponting ,AUS
1974,334,332,156,156,0,0,156,4 (4ct 0st),0.469,1985,2000,M Azharuddin ,INDIA
1975,140,139,154,110,44,110,0,5 (4ct 1st),1.107,1994,2000,NR Mongia ,INDIA
1976,193,193,154,125,29,96,29,5 (5ct 0st),0.797,2004,2019,BRM Taylor ,ZIM
1977,150,150,147,114,33,112,2,4 (4ct 0st),0.98,2001,2012,T Taibu ,ZIM
1978,179,178,141,116,25,111,5,5 (3ct 2st),0.792,1992,2002,AC Parore ,NZ
1979,116,114,140,116,24,116,0,6 (6ct 0st),1.228,2007,2019,Sarfaraz Ahmed ,PAK
1980,463,456,140,140,0,0,140,4 (4ct 0st),0.307,1989,2012,SR Tendulkar ,INDIA
1981,228,224,137,137,0,0,137,4 (4ct 0st),0.611,2006,2019,LRPL Taylor ,NZ
1982,265,260,135,135,0,5,130,4 (4ct 0st),0.519,2000,2015,Younis Khan ,PAK
1983,280,276,133,133,0,0,133,4 (4ct 0st),0.481,1994,2007,SP Fleming ,NZ
1984,328,324,131,131,0,0,131,3 (3ct 0st),0.4039999999999999,1996,2014,JH Kallis ,SA
1985,350,347,130,130,0,0,130,3 (3ct 0st),0.374,1993,2011,M Muralitharan ,SL
1986,273,270,127,127,0,0,127,3 (3ct 0st),0.47,1979,1994,AR Border ,AUS
1987,398,392,127,127,0,0,127,2 (2ct 0st),0.3229999999999999,1996,2015,Shahid Afridi ,PAK
1988,126,126,126,91,35,91,0,5 (3ct 2st),1.0,1995,2006,Khaled Mashud ,BDESH
1989,330,325,124,123,1,5,118,3 (3ct 0st),0.381,1999,2016,TM Dilshan ,SL
1990,301,294,124,124,0,0,124,3 (3ct 0st),0.421,1999,2019,CH Gayle ,WI
1991,242,240,124,124,0,0,124,3 (3ct 0st),0.516,2008,2019,V Kohli ,INDIA
1992,92,92,124,120,4,120,0,5 (5ct 0st),1.347,1971,1984,RW Marsh ,AUS
1993,445,441,123,123,0,0,123,3 (3ct 0st),0.278,1989,2011,ST Jayasuriya ,SL
1994,227,225,120,120,0,0,120,4 (4ct 0st),0.5329999999999999,1987,2003,CL Hooper ,WI
1995,299,296,120,120,0,0,120,3 (3ct 0st),0.405,1990,2007,BC Lara ,WI
1996,85,83,117,105,12,105,0,4 (4ct 0st),1.409,2008,2017,L Ronchi ,AUS
1997,94,94,117,108,9,108,0,5 (5ct 0st),1.244,2012,2017,MS Wade ,AUS
1998,378,373,113,113,0,0,113,3 (3ct 0st),0.302,1991,2007,Inzamam-ul-Haq ,PAK
1999,325,324,111,111,0,0,111,3 (3ct 0st),0.342,1986,2002,SR Waugh ,AUS
2000,404,397,501,402,99,383,19,5 (4ct 1st),1.261,2000,2015,KC Sangakkara ,SL
2001,287,286,472,417,55,417,0,6 (6ct 0st),1.65,1996,2008,AC Gilchrist ,AUS
2002,350,345,444,321,123,321,0,6 (5ct 1st),1.286,2004,2019,MS Dhoni ,INDIA
2003,295,291,425,403,22,402,1,6 (6ct 0st),1.46,1998,2011,MV Boucher ,SA
2004,219,217,287,214,73,214,0,5 (5ct 0st),1.3219999999999998,1990,2004,Moin Khan ,PAK
2005,260,257,277,262,15,227,35,5 (5ct 0st),1.077,2002,2016,BB McCullum ,NZ
2006,168,168,233,194,39,194,0,4 (4ct 0st),1.386,1988,1997,IA Healy ,AUS
2007,216,215,225,181,44,179,2,5 (5ct 0st),1.046,2006,2019,Mushfiqur Rahim ,BDESH
2008,166,164,220,182,38,182,0,5 (5ct 0st),1.341,1992,2003,Rashid Latif ,PAK
2009,448,443,218,218,0,0,218,4 (4ct 0st),0.492,1998,2015,DPMD Jayawardene ,SL
2010,344,341,210,196,14,72,124,4 (4ct 0st),0.615,1996,2011,R Dravid ,INDIA
2011,189,188,207,132,75,131,1,5 (4ct 1st),1.101,1990,2004,RS Kaluwitharana ,SL
2012,169,168,204,183,21,183,0,4 (4ct 0st),1.214,1981,1991,PJL Dujon ,WI
2013,142,138,202,171,31,171,0,6 (6ct 0st),1.463,2012,2019,JC Buttler ,ENG
2014,147,145,189,160,29,160,0,6 (5ct 1st),1.3030000000000002,1996,2004,RD Jacobs ,WI
2015,157,154,188,157,31,156,1,5 (4ct 1st),1.22,2002,2017,Kamran Akmal ,PAK
2016,139,137,188,181,7,181,0,5 (5ct 0st),1.372,2005,2016,D Ramdin ,WI
2017,228,223,181,176,5,93,83,5 (5ct 0st),0.8109999999999999,2005,2018,AB de Villiers ,SA
2018,126,124,181,170,11,170,0,5 (5ct 0st),1.459,2001,2015,BJ Haddin ,AUS
2019,170,169,174,159,15,148,11,6 (6ct 0st),1.029,1989,2003,AJ Stewart ,ENG
2020,213,212,173,141,32,133,8,5 (5ct 0st),0.816,1992,2003,A Flower ,ZIM
2021,115,111,166,158,8,158,0,6 (5ct 1st),1.495,2013,2019,Q de Kock ,SA
2022,122,121,165,148,17,148,0,5 (5ct 0st),1.3630000000000002,1991,1998,DJ Richardson ,SA
2023,375,372,160,160,0,0,160,3 (3ct 0st),0.43,1995,2012,RT Ponting ,AUS
2024,334,332,156,156,0,0,156,4 (4ct 0st),0.469,1985,2000,M Azharuddin ,INDIA
2025,140,139,154,110,44,110,0,5 (4ct 1st),1.107,1994,2000,NR Mongia ,INDIA
2026,193,193,154,125,29,96,29,5 (5ct 0st),0.797,2004,2019,BRM Taylor ,ZIM
2027,150,150,147,114,33,112,2,4 (4ct 0st),0.98,2001,2012,T Taibu ,ZIM
2028,179,178,141,116,25,111,5,5 (3ct 2st),0.792,1992,2002,AC Parore ,NZ
2029,116,114,140,116,24,116,0,6 (6ct 0st),1.228,2007,2019,Sarfaraz Ahmed ,PAK
2030,463,456,140,140,0,0,140,4 (4ct 0st),0.307,1989,2012,SR Tendulkar ,INDIA
2031,228,224,137,137,0,0,137,4 (4ct 0st),0.611,2006,2019,LRPL Taylor ,NZ
2032,265,260,135,135,0,5,130,4 (4ct 0st),0.519,2000,2015,Younis Khan ,PAK
2033,280,276,133,133,0,0,133,4 (4ct 0st),0.481,1994,2007,SP Fleming ,NZ
2034,328,324,131,131,0,0,131,3 (3ct 0st),0.4039999999999999,1996,2014,JH Kallis ,SA
2035,350,347,130,130,0,0,130,3 (3ct 0st),0.374,1993,2011,M Muralitharan ,SL
2036,273,270,127,127,0,0,127,3 (3ct 0st),0.47,1979,1994,AR Border ,AUS
2037,398,392,127,127,0,0,127,2 (2ct 0st),0.3229999999999999,1996,2015,Shahid Afridi ,PAK
2038,126,126,126,91,35,91,0,5 (3ct 2st),1.0,1995,2006,Khaled Mashud ,BDESH
2039,330,325,124,123,1,5,118,3 (3ct 0st),0.381,1999,2016,TM Dilshan ,SL
2040,301,294,124,124,0,0,124,3 (3ct 0st),0.421,1999,2019,CH Gayle ,WI
2041,242,240,124,124,0,0,124,3 (3ct 0st),0.516,2008,2019,V Kohli ,INDIA
2042,92,92,124,120,4,120,0,5 (5ct 0st),1.347,1971,1984,RW Marsh ,AUS
2043,445,441,123,123,0,0,123,3 (3ct 0st),0.278,1989,2011,ST Jayasuriya ,SL
2044,227,225,120,120,0,0,120,4 (4ct 0st),0.5329999999999999,1987,2003,CL Hooper ,WI
2045,299,296,120,120,0,0,120,3 (3ct 0st),0.405,1990,2007,BC Lara ,WI
2046,85,83,117,105,12,105,0,4 (4ct 0st),1.409,2008,2017,L Ronchi ,AUS
2047,94,94,117,108,9,108,0,5 (5ct 0st),1.244,2012,2017,MS Wade ,AUS
2048,378,373,113,113,0,0,113,3 (3ct 0st),0.302,1991,2007,Inzamam-ul-Haq ,PAK
2049,325,324,111,111,0,0,111,3 (3ct 0st),0.342,1986,2002,SR Waugh ,AUS
2050,404,397,501,402,99,383,19,5 (4ct 1st),1.261,2000,2015,KC Sangakkara ,SL
2051,287,286,472,417,55,417,0,6 (6ct 0st),1.65,1996,2008,AC Gilchrist ,AUS
2052,350,345,444,321,123,321,0,6 (5ct 1st),1.286,2004,2019,MS Dhoni ,INDIA
2053,295,291,425,403,22,402,1,6 (6ct 0st),1.46,1998,2011,MV Boucher ,SA
2054,219,217,287,214,73,214,0,5 (5ct 0st),1.3219999999999998,1990,2004,Moin Khan ,PAK
2055,260,257,277,262,15,227,35,5 (5ct 0st),1.077,2002,2016,BB McCullum ,NZ
2056,168,168,233,194,39,194,0,4 (4ct 0st),1.386,1988,1997,IA Healy ,AUS
2057,216,215,225,181,44,179,2,5 (5ct 0st),1.046,2006,2019,Mushfiqur Rahim ,BDESH
2058,166,164,220,182,38,182,0,5 (5ct 0st),1.341,1992,2003,Rashid Latif ,PAK
2059,448,443,218,218,0,0,218,4 (4ct 0st),0.492,1998,2015,DPMD Jayawardene ,SL
2060,344,341,210,196,14,72,124,4 (4ct 0st),0.615,1996,2011,R Dravid ,INDIA
2061,189,188,207,132,75,131,1,5 (4ct 1st),1.101,1990,2004,RS Kaluwitharana ,SL
2062,169,168,204,183,21,183,0,4 (4ct 0st),1.214,1981,1991,PJL Dujon ,WI
2063,142,138,202,171,31,171,0,6 (6ct 0st),1.463,2012,2019,JC Buttler ,ENG
2064,147,145,189,160,29,160,0,6 (5ct 1st),1.3030000000000002,1996,2004,RD Jacobs ,WI
2065,157,154,188,157,31,156,1,5 (4ct 1st),1.22,2002,2017,Kamran Akmal ,PAK
2066,139,137,188,181,7,181,0,5 (5ct 0st),1.372,2005,2016,D Ramdin ,WI
2067,228,223,181,176,5,93,83,5 (5ct 0st),0.8109999999999999,2005,2018,AB de Villiers ,SA
2068,126,124,181,170,11,170,0,5 (5ct 0st),1.459,2001,2015,BJ Haddin ,AUS
2069,170,169,174,159,15,148,11,6 (6ct 0st),1.029,1989,2003,AJ Stewart ,ENG
2070,213,212,173,141,32,133,8,5 (5ct 0st),0.816,1992,2003,A Flower ,ZIM
2071,115,111,166,158,8,158,0,6 (5ct 1st),1.495,2013,2019,Q de Kock ,SA
2072,122,121,165,148,17,148,0,5 (5ct 0st),1.3630000000000002,1991,1998,DJ Richardson ,SA
2073,375,372,160,160,0,0,160,3 (3ct 0st),0.43,1995,2012,RT Ponting ,AUS
2074,334,332,156,156,0,0,156,4 (4ct 0st),0.469,1985,2000,M Azharuddin ,INDIA
2075,140,139,154,110,44,110,0,5 (4ct 1st),1.107,1994,2000,NR Mongia ,INDIA
2076,193,193,154,125,29,96,29,5 (5ct 0st),0.797,2004,2019,BRM Taylor ,ZIM
2077,150,150,147,114,33,112,2,4 (4ct 0st),0.98,2001,2012,T Taibu ,ZIM
2078,179,178,141,116,25,111,5,5 (3ct 2st),0.792,1992,2002,AC Parore ,NZ
2079,116,114,140,116,24,116,0,6 (6ct 0st),1.228,2007,2019,Sarfaraz Ahmed ,PAK
2080,463,456,140,140,0,0,140,4 (4ct 0st),0.307,1989,2012,SR Tendulkar ,INDIA
2081,228,224,137,137,0,0,137,4 (4ct 0st),0.611,2006,2019,LRPL Taylor ,NZ
2082,265,260,135,135,0,5,130,4 (4ct 0st),0.519,2000,2015,Younis Khan ,PAK
2083,280,276,133,133,0,0,133,4 (4ct 0st),0.481,1994,2007,SP Fleming ,NZ
2084,328,324,131,131,0,0,131,3 (3ct 0st),0.4039999999999999,1996,2014,JH Kallis ,SA
2085,350,347,130,130,0,0,130,3 (3ct 0st),0.374,1993,2011,M Muralitharan ,SL
2086,273,270,127,127,0,0,127,3 (3ct 0st),0.47,1979,1994,AR Border ,AUS
2087,398,392,127,127,0,0,127,2 (2ct 0st),0.3229999999999999,1996,2015,Shahid Afridi ,PAK
2088,126,126,126,91,35,91,0,5 (3ct 2st),1.0,1995,2006,Khaled Mashud ,BDESH
2089,330,325,124,123,1,5,118,3 (3ct 0st),0.381,1999,2016,TM Dilshan ,SL
2090,301,294,124,124,0,0,124,3 (3ct 0st),0.421,1999,2019,CH Gayle ,WI
2091,242,240,124,124,0,0,124,3 (3ct 0st),0.516,2008,2019,V Kohli ,INDIA
2092,92,92,124,120,4,120,0,5 (5ct 0st),1.347,1971,1984,RW Marsh ,AUS
2093,445,441,123,123,0,0,123,3 (3ct 0st),0.278,1989,2011,ST Jayasuriya ,SL
2094,227,225,120,120,0,0,120,4 (4ct 0st),0.5329999999999999,1987,2003,CL Hooper ,WI
2095,299,296,120,120,0,0,120,3 (3ct 0st),0.405,1990,2007,BC Lara ,WI
2096,85,83,117,105,12,105,0,4 (4ct 0st),1.409,2008,2017,L Ronchi ,AUS
2097,94,94,117,108,9,108,0,5 (5ct 0st),1.244,2012,2017,MS Wade ,AUS
2098,378,373,113,113,0,0,113,3 (3ct 0st),0.302,1991,2007,Inzamam-ul-Haq ,PAK
2099,325,324,111,111,0,0,111,3 (3ct 0st),0.342,1986,2002,SR Waugh ,AUS
2100,404,397,501,402,99,383,19,5 (4ct 1st),1.261,2000,2015,KC Sangakkara ,SL
2101,287,286,472,417,55,417,0,6 (6ct 0st),1.65,1996,2008,AC Gilchrist ,AUS
2102,350,345,444,321,123,321,0,6 (5ct 1st),1.286,2004,2019,MS Dhoni ,INDIA
2103,295,291,425,403,22,402,1,6 (6ct 0st),1.46,1998,2011,MV Boucher ,SA
2104,219,217,287,214,73,214,0,5 (5ct 0st),1.3219999999999998,1990,2004,Moin Khan ,PAK
2105,260,257,277,262,15,227,35,5 (5ct 0st),1.077,2002,2016,BB McCullum ,NZ
2106,168,168,233,194,39,194,0,4 (4ct 0st),1.386,1988,1997,IA Healy ,AUS
2107,216,215,225,181,44,179,2,5 (5ct 0st),1.046,2006,2019,Mushfiqur Rahim ,BDESH
2108,166,164,220,182,38,182,0,5 (5ct 0st),1.341,1992,2003,Rashid Latif ,PAK
2109,448,443,218,218,0,0,218,4 (4ct 0st),0.492,1998,2015,DPMD Jayawardene ,SL
2110,344,341,210,196,14,72,124,4 (4ct 0st),0.615,1996,2011,R Dravid ,INDIA
2111,189,188,207,132,75,131,1,5 (4ct 1st),1.101,1990,2004,RS Kaluwitharana ,SL
2112,169,168,204,183,21,183,0,4 (4ct 0st),1.214,1981,1991,PJL Dujon ,WI
2113,142,138,202,171,31,171,0,6 (6ct 0st),1.463,2012,2019,JC Buttler ,ENG
2114,147,145,189,160,29,160,0,6 (5ct 1st),1.3030000000000002,1996,2004,RD Jacobs ,WI
2115,157,154,188,157,31,156,1,5 (4ct 1st),1.22,2002,2017,Kamran Akmal ,PAK
2116,139,137,188,181,7,181,0,5 (5ct 0st),1.372,2005,2016,D Ramdin ,WI
2117,228,223,181,176,5,93,83,5 (5ct 0st),0.8109999999999999,2005,2018,AB de Villiers ,SA
2118,126,124,181,170,11,170,0,5 (5ct 0st),1.459,2001,2015,BJ Haddin ,AUS
2119,170,169,174,159,15,148,11,6 (6ct 0st),1.029,1989,2003,AJ Stewart ,ENG
2120,213,212,173,141,32,133,8,5 (5ct 0st),0.816,1992,2003,A Flower ,ZIM
2121,115,111,166,158,8,158,0,6 (5ct 1st),1.495,2013,2019,Q de Kock ,SA
2122,122,121,165,148,17,148,0,5 (5ct 0st),1.3630000000000002,1991,1998,DJ Richardson ,SA
2123,375,372,160,160,0,0,160,3 (3ct 0st),0.43,1995,2012,RT Ponting ,AUS
2124,334,332,156,156,0,0,156,4 (4ct 0st),0.469,1985,2000,M Azharuddin ,INDIA
2125,140,139,154,110,44,110,0,5 (4ct 1st),1.107,1994,2000,NR Mongia ,INDIA
2126,193,193,154,125,29,96,29,5 (5ct 0st),0.797,2004,2019,BRM Taylor ,ZIM
2127,150,150,147,114,33,112,2,4 (4ct 0st),0.98,2001,2012,T Taibu ,ZIM
2128,179,178,141,116,25,111,5,5 (3ct 2st),0.792,1992,2002,AC Parore ,NZ
2129,116,114,140,116,24,116,0,6 (6ct 0st),1.228,2007,2019,Sarfaraz Ahmed ,PAK
2130,463,456,140,140,0,0,140,4 (4ct 0st),0.307,1989,2012,SR Tendulkar ,INDIA
2131,228,224,137,137,0,0,137,4 (4ct 0st),0.611,2006,2019,LRPL Taylor ,NZ
2132,265,260,135,135,0,5,130,4 (4ct 0st),0.519,2000,2015,Younis Khan ,PAK
2133,280,276,133,133,0,0,133,4 (4ct 0st),0.481,1994,2007,SP Fleming ,NZ
2134,328,324,131,131,0,0,131,3 (3ct 0st),0.4039999999999999,1996,2014,JH Kallis ,SA
2135,350,347,130,130,0,0,130,3 (3ct 0st),0.374,1993,2011,M Muralitharan ,SL
2136,273,270,127,127,0,0,127,3 (3ct 0st),0.47,1979,1994,AR Border ,AUS
2137,398,392,127,127,0,0,127,2 (2ct 0st),0.3229999999999999,1996,2015,Shahid Afridi ,PAK
2138,126,126,126,91,35,91,0,5 (3ct 2st),1.0,1995,2006,Khaled Mashud ,BDESH
2139,330,325,124,123,1,5,118,3 (3ct 0st),0.381,1999,2016,TM Dilshan ,SL
2140,301,294,124,124,0,0,124,3 (3ct 0st),0.421,1999,2019,CH Gayle ,WI
2141,242,240,124,124,0,0,124,3 (3ct 0st),0.516,2008,2019,V Kohli ,INDIA
2142,92,92,124,120,4,120,0,5 (5ct 0st),1.347,1971,1984,RW Marsh ,AUS
2143,445,441,123,123,0,0,123,3 (3ct 0st),0.278,1989,2011,ST Jayasuriya ,SL
2144,227,225,120,120,0,0,120,4 (4ct 0st),0.5329999999999999,1987,2003,CL Hooper ,WI
2145,299,296,120,120,0,0,120,3 (3ct 0st),0.405,1990,2007,BC Lara ,WI
2146,85,83,117,105,12,105,0,4 (4ct 0st),1.409,2008,2017,L Ronchi ,AUS
2147,94,94,117,108,9,108,0,5 (5ct 0st),1.244,2012,2017,MS Wade ,AUS
2148,378,373,113,113,0,0,113,3 (3ct 0st),0.302,1991,2007,Inzamam-ul-Haq ,PAK
2149,325,324,111,111,0,0,111,3 (3ct 0st),0.342,1986,2002,SR Waugh ,AUS
2150,404,397,501,402,99,383,19,5 (4ct 1st),1.261,2000,2015,KC Sangakkara ,SL
2151,287,286,472,417,55,417,0,6 (6ct 0st),1.65,1996,2008,AC Gilchrist ,AUS
2152,350,345,444,321,123,321,0,6 (5ct 1st),1.286,2004,2019,MS Dhoni ,INDIA
2153,295,291,425,403,22,402,1,6 (6ct 0st),1.46,1998,2011,MV Boucher ,SA
2154,219,217,287,214,73,214,0,5 (5ct 0st),1.3219999999999998,1990,2004,Moin Khan ,PAK
2155,260,257,277,262,15,227,35,5 (5ct 0st),1.077,2002,2016,BB McCullum ,NZ
2156,168,168,233,194,39,194,0,4 (4ct 0st),1.386,1988,1997,IA Healy ,AUS
2157,216,215,225,181,44,179,2,5 (5ct 0st),1.046,2006,2019,Mushfiqur Rahim ,BDESH
2158,166,164,220,182,38,182,0,5 (5ct 0st),1.341,1992,2003,Rashid Latif ,PAK
2159,448,443,218,218,0,0,218,4 (4ct 0st),0.492,1998,2015,DPMD Jayawardene ,SL
2160,344,341,210,196,14,72,124,4 (4ct 0st),0.615,1996,2011,R Dravid ,INDIA
2161,189,188,207,132,75,131,1,5 (4ct 1st),1.101,1990,2004,RS Kaluwitharana ,SL
2162,169,168,204,183,21,183,0,4 (4ct 0st),1.214,1981,1991,PJL Dujon ,WI
2163,142,138,202,171,31,171,0,6 (6ct 0st),1.463,2012,2019,JC Buttler ,ENG
2164,147,145,189,160,29,160,0,6 (5ct 1st),1.3030000000000002,1996,2004,RD Jacobs ,WI
2165,157,154,188,157,31,156,1,5 (4ct 1st),1.22,2002,2017,Kamran Akmal ,PAK
2166,139,137,188,181,7,181,0,5 (5ct 0st),1.372,2005,2016,D Ramdin ,WI
2167,228,223,181,176,5,93,83,5 (5ct 0st),0.8109999999999999,2005,2018,AB de Villiers ,SA
2168,126,124,181,170,11,170,0,5 (5ct 0st),1.459,2001,2015,BJ Haddin ,AUS
2169,170,169,174,159,15,148,11,6 (6ct 0st),1.029,1989,2003,AJ Stewart ,ENG
2170,213,212,173,141,32,133,8,5 (5ct 0st),0.816,1992,2003,A Flower ,ZIM
2171,115,111,166,158,8,158,0,6 (5ct 1st),1.495,2013,2019,Q de Kock ,SA
2172,122,121,165,148,17,148,0,5 (5ct 0st),1.3630000000000002,1991,1998,DJ Richardson ,SA
2173,375,372,160,160,0,0,160,3 (3ct 0st),0.43,1995,2012,RT Ponting ,AUS
2174,334,332,156,156,0,0,156,4 (4ct 0st),0.469,1985,2000,M Azharuddin ,INDIA
2175,140,139,154,110,44,110,0,5 (4ct 1st),1.107,1994,2000,NR Mongia ,INDIA
2176,193,193,154,125,29,96,29,5 (5ct 0st),0.797,2004,2019,BRM Taylor ,ZIM
2177,150,150,147,114,33,112,2,4 (4ct 0st),0.98,2001,2012,T Taibu ,ZIM
2178,179,178,141,116,25,111,5,5 (3ct 2st),0.792,1992,2002,AC Parore ,NZ
2179,116,114,140,116,24,116,0,6 (6ct 0st),1.228,2007,2019,Sarfaraz Ahmed ,PAK
2180,463,456,140,140,0,0,140,4 (4ct 0st),0.307,1989,2012,SR Tendulkar ,INDIA
2181,228,224,137,137,0,0,137,4 (4ct 0st),0.611,2006,2019,LRPL Taylor ,NZ
2182,265,260,135,135,0,5,130,4 (4ct 0st),0.519,2000,2015,Younis Khan ,PAK
2183,280,276,133,133,0,0,133,4 (4ct 0st),0.481,1994,2007,SP Fleming ,NZ
2184,328,324,131,131,0,0,131,3 (3ct 0st),0.4039999999999999,1996,2014,JH Kallis ,SA
2185,350,347,130,130,0,0,130,3 (3ct 0st),0.374,1993,2011,M Muralitharan ,SL
2186,273,270,127,127,0,0,127,3 (3ct 0st),0.47,1979,1994,AR Border ,AUS
2187,398,392,127,127,0,0,127,2 (2ct 0st),0.3229999999999999,1996,2015,Shahid Afridi ,PAK
2188,126,126,126,91,35,91,0,5 (3ct 2st),1.0,1995,2006,Khaled Mashud ,BDESH
2189,330,325,124,123,1,5,118,3 (3ct 0st),0.381,1999,2016,TM Dilshan ,SL
2190,301,294,124,124,0,0,124,3 (3ct 0st),0.421,1999,2019,CH Gayle ,WI
2191,242,240,124,124,0,0,124,3 (3ct 0st),0.516,2008,2019,V Kohli ,INDIA
2192,92,92,124,120,4,120,0,5 (5ct 0st),1.347,1971,1984,RW Marsh ,AUS
2193,445,441,123,123,0,0,123,3 (3ct 0st),0.278,1989,2011,ST Jayasuriya ,SL
2194,227,225,120,120,0,0,120,4 (4ct 0st),0.5329999999999999,1987,2003,CL Hooper ,WI
2195,299,296,120,120,0,0,120,3 (3ct 0st),0.405,1990,2007,BC Lara ,WI
2196,85,83,117,105,12,105,0,4 (4ct 0st),1.409,2008,2017,L Ronchi ,AUS
2197,94,94,117,108,9,108,0,5 (5ct 0st),1.244,2012,2017,MS Wade ,AUS
2198,378,373,113,113,0,0,113,3 (3ct 0st),0.302,1991,2007,Inzamam-ul-Haq ,PAK
2199,325,324,111,111,0,0,111,3 (3ct 0st),0.342,1986,2002,SR Waugh ,AUS
2200,404,397,501,402,99,383,19,5 (4ct 1st),1.261,2000,2015,KC Sangakkara ,SL
2201,287,286,472,417,55,417,0,6 (6ct 0st),1.65,1996,2008,AC Gilchrist ,AUS
2202,350,345,444,321,123,321,0,6 (5ct 1st),1.286,2004,2019,MS Dhoni ,INDIA
2203,295,291,425,403,22,402,1,6 (6ct 0st),1.46,1998,2011,MV Boucher ,SA
2204,219,217,287,214,73,214,0,5 (5ct 0st),1.3219999999999998,1990,2004,Moin Khan ,PAK
2205,260,257,277,262,15,227,35,5 (5ct 0st),1.077,2002,2016,BB McCullum ,NZ
2206,168,168,233,194,39,194,0,4 (4ct 0st),1.386,1988,1997,IA Healy ,AUS
2207,216,215,225,181,44,179,2,5 (5ct 0st),1.046,2006,2019,Mushfiqur Rahim ,BDESH
2208,166,164,220,182,38,182,0,5 (5ct 0st),1.341,1992,2003,Rashid Latif ,PAK
2209,448,443,218,218,0,0,218,4 (4ct 0st),0.492,1998,2015,DPMD Jayawardene ,SL
2210,344,341,210,196,14,72,124,4 (4ct 0st),0.615,1996,2011,R Dravid ,INDIA
2211,189,188,207,132,75,131,1,5 (4ct 1st),1.101,1990,2004,RS Kaluwitharana ,SL
2212,169,168,204,183,21,183,0,4 (4ct 0st),1.214,1981,1991,PJL Dujon ,WI
2213,142,138,202,171,31,171,0,6 (6ct 0st),1.463,2012,2019,JC Buttler ,ENG
2214,147,145,189,160,29,160,0,6 (5ct 1st),1.3030000000000002,1996,2004,RD Jacobs ,WI
2215,157,154,188,157,31,156,1,5 (4ct 1st),1.22,2002,2017,Kamran Akmal ,PAK
2216,139,137,188,181,7,181,0,5 (5ct 0st),1.372,2005,2016,D Ramdin ,WI
2217,228,223,181,176,5,93,83,5 (5ct 0st),0.8109999999999999,2005,2018,AB de Villiers ,SA
2218,126,124,181,170,11,170,0,5 (5ct 0st),1.459,2001,2015,BJ Haddin ,AUS
2219,170,169,174,159,15,148,11,6 (6ct 0st),1.029,1989,2003,AJ Stewart ,ENG
2220,213,212,173,141,32,133,8,5 (5ct 0st),0.816,1992,2003,A Flower ,ZIM
2221,115,111,166,158,8,158,0,6 (5ct 1st),1.495,2013,2019,Q de Kock ,SA
2222,122,121,165,148,17,148,0,5 (5ct 0st),1.3630000000000002,1991,1998,DJ Richardson ,SA
2223,375,372,160,160,0,0,160,3 (3ct 0st),0.43,1995,2012,RT Ponting ,AUS
2224,334,332,156,156,0,0,156,4 (4ct 0st),0.469,1985,2000,M Azharuddin ,INDIA
2225,140,139,154,110,44,110,0,5 (4ct 1st),1.107,1994,2000,NR Mongia ,INDIA
2226,193,193,154,125,29,96,29,5 (5ct 0st),0.797,2004,2019,BRM Taylor ,ZIM
2227,150,150,147,114,33,112,2,4 (4ct 0st),0.98,2001,2012,T Taibu ,ZIM
2228,179,178,141,116,25,111,5,5 (3ct 2st),0.792,1992,2002,AC Parore ,NZ
2229,116,114,140,116,24,116,0,6 (6ct 0st),1.228,2007,2019,Sarfaraz Ahmed ,PAK
2230,463,456,140,140,0,0,140,4 (4ct 0st),0.307,1989,2012,SR Tendulkar ,INDIA
2231,228,224,137,137,0,0,137,4 (4ct 0st),0.611,2006,2019,LRPL Taylor ,NZ
2232,265,260,135,135,0,5,130,4 (4ct 0st),0.519,2000,2015,Younis Khan ,PAK
2233,280,276,133,133,0,0,133,4 (4ct 0st),0.481,1994,2007,SP Fleming ,NZ
2234,328,324,131,131,0,0,131,3 (3ct 0st),0.4039999999999999,1996,2014,JH Kallis ,SA
2235,350,347,130,130,0,0,130,3 (3ct 0st),0.374,1993,2011,M Muralitharan ,SL
2236,273,270,127,127,0,0,127,3 (3ct 0st),0.47,1979,1994,AR Border ,AUS
2237,398,392,127,127,0,0,127,2 (2ct 0st),0.3229999999999999,1996,2015,Shahid Afridi ,PAK
2238,126,126,126,91,35,91,0,5 (3ct 2st),1.0,1995,2006,Khaled Mashud ,BDESH
2239,330,325,124,123,1,5,118,3 (3ct 0st),0.381,1999,2016,TM Dilshan ,SL
2240,301,294,124,124,0,0,124,3 (3ct 0st),0.421,1999,2019,CH Gayle ,WI
2241,242,240,124,124,0,0,124,3 (3ct 0st),0.516,2008,2019,V Kohli ,INDIA
2242,92,92,124,120,4,120,0,5 (5ct 0st),1.347,1971,1984,RW Marsh ,AUS
2243,445,441,123,123,0,0,123,3 (3ct 0st),0.278,1989,2011,ST Jayasuriya ,SL
2244,227,225,120,120,0,0,120,4 (4ct 0st),0.5329999999999999,1987,2003,CL Hooper ,WI
2245,299,296,120,120,0,0,120,3 (3ct 0st),0.405,1990,2007,BC Lara ,WI
2246,85,83,117,105,12,105,0,4 (4ct 0st),1.409,2008,2017,L Ronchi ,AUS
2247,94,94,117,108,9,108,0,5 (5ct 0st),1.244,2012,2017,MS Wade ,AUS
2248,378,373,113,113,0,0,113,3 (3ct 0st),0.302,1991,2007,Inzamam-ul-Haq ,PAK
2249,325,324,111,111,0,0,111,3 (3ct 0st),0.342,1986,2002,SR Waugh ,AUS
2250,404,397,501,402,99,383,19,5 (4ct 1st),1.261,2000,2015,KC Sangakkara ,SL
2251,287,286,472,417,55,417,0,6 (6ct 0st),1.65,1996,2008,AC Gilchrist ,AUS
2252,350,345,444,321,123,321,0,6 (5ct 1st),1.286,2004,2019,MS Dhoni ,INDIA
2253,295,291,425,403,22,402,1,6 (6ct 0st),1.46,1998,2011,MV Boucher ,SA
2254,219,217,287,214,73,214,0,5 (5ct 0st),1.3219999999999998,1990,2004,Moin Khan ,PAK
2255,260,257,277,262,15,227,35,5 (5ct 0st),1.077,2002,2016,BB McCullum ,NZ
2256,168,168,233,194,39,194,0,4 (4ct 0st),1.386,1988,1997,IA Healy ,AUS
2257,216,215,225,181,44,179,2,5 (5ct 0st),1.046,2006,2019,Mushfiqur Rahim ,BDESH
2258,166,164,220,182,38,182,0,5 (5ct 0st),1.341,1992,2003,Rashid Latif ,PAK
2259,448,443,218,218,0,0,218,4 (4ct 0st),0.492,1998,2015,DPMD Jayawardene ,SL
2260,344,341,210,196,14,72,124,4 (4ct 0st),0.615,1996,2011,R Dravid ,INDIA
2261,189,188,207,132,75,131,1,5 (4ct 1st),1.101,1990,2004,RS Kaluwitharana ,SL
2262,169,168,204,183,21,183,0,4 (4ct 0st),1.214,1981,1991,PJL Dujon ,WI
2263,142,138,202,171,31,171,0,6 (6ct 0st),1.463,2012,2019,JC Buttler ,ENG
2264,147,145,189,160,29,160,0,6 (5ct 1st),1.3030000000000002,1996,2004,RD Jacobs ,WI
2265,157,154,188,157,31,156,1,5 (4ct 1st),1.22,2002,2017,Kamran Akmal ,PAK
2266,139,137,188,181,7,181,0,5 (5ct 0st),1.372,2005,2016,D Ramdin ,WI
2267,228,223,181,176,5,93,83,5 (5ct 0st),0.8109999999999999,2005,2018,AB de Villiers ,SA
2268,126,124,181,170,11,170,0,5 (5ct 0st),1.459,2001,2015,BJ Haddin ,AUS
2269,170,169,174,159,15,148,11,6 (6ct 0st),1.029,1989,2003,AJ Stewart ,ENG
2270,213,212,173,141,32,133,8,5 (5ct 0st),0.816,1992,2003,A Flower ,ZIM
2271,115,111,166,158,8,158,0,6 (5ct 1st),1.495,2013,2019,Q de Kock ,SA
2272,122,121,165,148,17,148,0,5 (5ct 0st),1.3630000000000002,1991,1998,DJ Richardson ,SA
2273,375,372,160,160,0,0,160,3 (3ct 0st),0.43,1995,2012,RT Ponting ,AUS
2274,334,332,156,156,0,0,156,4 (4ct 0st),0.469,1985,2000,M Azharuddin ,INDIA
2275,140,139,154,110,44,110,0,5 (4ct 1st),1.107,1994,2000,NR Mongia ,INDIA
2276,193,193,154,125,29,96,29,5 (5ct 0st),0.797,2004,2019,BRM Taylor ,ZIM
2277,150,150,147,114,33,112,2,4 (4ct 0st),0.98,2001,2012,T Taibu ,ZIM
2278,179,178,141,116,25,111,5,5 (3ct 2st),0.792,1992,2002,AC Parore ,NZ
2279,116,114,140,116,24,116,0,6 (6ct 0st),1.228,2007,2019,Sarfaraz Ahmed ,PAK
2280,463,456,140,140,0,0,140,4 (4ct 0st),0.307,1989,2012,SR Tendulkar ,INDIA
2281,228,224,137,137,0,0,137,4 (4ct 0st),0.611,2006,2019,LRPL Taylor ,NZ
2282,265,260,135,135,0,5,130,4 (4ct 0st),0.519,2000,2015,Younis Khan ,PAK
2283,280,276,133,133,0,0,133,4 (4ct 0st),0.481,1994,2007,SP Fleming ,NZ
2284,328,324,131,131,0,0,131,3 (3ct 0st),0.4039999999999999,1996,2014,JH Kallis ,SA
2285,350,347,130,130,0,0,130,3 (3ct 0st),0.374,1993,2011,M Muralitharan ,SL
2286,273,270,127,127,0,0,127,3 (3ct 0st),0.47,1979,1994,AR Border ,AUS
2287,398,392,127,127,0,0,127,2 (2ct 0st),0.3229999999999999,1996,2015,Shahid Afridi ,PAK
2288,126,126,126,91,35,91,0,5 (3ct 2st),1.0,1995,2006,Khaled Mashud ,BDESH
2289,330,325,124,123,1,5,118,3 (3ct 0st),0.381,1999,2016,TM Dilshan ,SL
2290,301,294,124,124,0,0,124,3 (3ct 0st),0.421,1999,2019,CH Gayle ,WI
2291,242,240,124,124,0,0,124,3 (3ct 0st),0.516,2008,2019,V Kohli ,INDIA
2292,92,92,124,120,4,120,0,5 (5ct 0st),1.347,1971,1984,RW Marsh ,AUS
2293,445,441,123,123,0,0,123,3 (3ct 0st),0.278,1989,2011,ST Jayasuriya ,SL
2294,227,225,120,120,0,0,120,4 (4ct 0st),0.5329999999999999,1987,2003,CL Hooper ,WI
2295,299,296,120,120,0,0,120,3 (3ct 0st),0.405,1990,2007,BC Lara ,WI
2296,85,83,117,105,12,105,0,4 (4ct 0st),1.409,2008,2017,L Ronchi ,AUS
2297,94,94,117,108,9,108,0,5 (5ct 0st),1.244,2012,2017,MS Wade ,AUS
2298,378,373,113,113,0,0,113,3 (3ct 0st),0.302,1991,2007,Inzamam-ul-Haq ,PAK
2299,325,324,111,111,0,0,111,3 (3ct 0st),0.342,1986,2002,SR Waugh ,AUS
2300,404,397,501,402,99,383,19,5 (4ct 1st),1.261,2000,2015,KC Sangakkara ,SL
2301,287,286,472,417,55,417,0,6 (6ct 0st),1.65,1996,2008,AC Gilchrist ,AUS
2302,350,345,444,321,123,321,0,6 (5ct 1st),1.286,2004,2019,MS Dhoni ,INDIA
2303,295,291,425,403,22,402,1,6 (6ct 0st),1.46,1998,2011,MV Boucher ,SA
2304,219,217,287,214,73,214,0,5 (5ct 0st),1.3219999999999998,1990,2004,Moin Khan ,PAK
2305,260,257,277,262,15,227,35,5 (5ct 0st),1.077,2002,2016,BB McCullum ,NZ
2306,168,168,233,194,39,194,0,4 (4ct 0st),1.386,1988,1997,IA Healy ,AUS
2307,216,215,225,181,44,179,2,5 (5ct 0st),1.046,2006,2019,Mushfiqur Rahim ,BDESH
2308,166,164,220,182,38,182,0,5 (5ct 0st),1.341,1992,2003,Rashid Latif ,PAK
2309,448,443,218,218,0,0,218,4 (4ct 0st),0.492,1998,2015,DPMD Jayawardene ,SL
2310,344,341,210,196,14,72,124,4 (4ct 0st),0.615,1996,2011,R Dravid ,INDIA
2311,189,188,207,132,75,131,1,5 (4ct 1st),1.101,1990,2004,RS Kaluwitharana ,SL
2312,169,168,204,183,21,183,0,4 (4ct 0st),1.214,1981,1991,PJL Dujon ,WI
2313,142,138,202,171,31,171,0,6 (6ct 0st),1.463,2012,2019,JC Buttler ,ENG
2314,147,145,189,160,29,160,0,6 (5ct 1st),1.3030000000000002,1996,2004,RD Jacobs ,WI
2315,157,154,188,157,31,156,1,5 (4ct 1st),1.22,2002,2017,Kamran Akmal ,PAK
2316,139,137,188,181,7,181,0,5 (5ct 0st),1.372,2005,2016,D Ramdin ,WI
2317,228,223,181,176,5,93,83,5 (5ct 0st),0.8109999999999999,2005,2018,AB de Villiers ,SA
2318,126,124,181,170,11,170,0,5 (5ct 0st),1.459,2001,2015,BJ Haddin ,AUS
2319,170,169,174,159,15,148,11,6 (6ct 0st),1.029,1989,2003,AJ Stewart ,ENG
2320,213,212,173,141,32,133,8,5 (5ct 0st),0.816,1992,2003,A Flower ,ZIM
2321,115,111,166,158,8,158,0,6 (5ct 1st),1.495,2013,2019,Q de Kock ,SA
2322,122,121,165,148,17,148,0,5 (5ct 0st),1.3630000000000002,1991,1998,DJ Richardson ,SA
2323,375,372,160,160,0,0,160,3 (3ct 0st),0.43,1995,2012,RT Ponting ,AUS
2324,334,332,156,156,0,0,156,4 (4ct 0st),0.469,1985,2000,M Azharuddin ,INDIA
2325,140,139,154,110,44,110,0,5 (4ct 1st),1.107,1994,2000,NR Mongia ,INDIA
2326,193,193,154,125,29,96,29,5 (5ct 0st),0.797,2004,2019,BRM Taylor ,ZIM
2327,150,150,147,114,33,112,2,4 (4ct 0st),0.98,2001,2012,T Taibu ,ZIM
2328,179,178,141,116,25,111,5,5 (3ct 2st),0.792,1992,2002,AC Parore ,NZ
2329,116,114,140,116,24,116,0,6 (6ct 0st),1.228,2007,2019,Sarfaraz Ahmed ,PAK
2330,463,456,140,140,0,0,140,4 (4ct 0st),0.307,1989,2012,SR Tendulkar ,INDIA
2331,228,224,137,137,0,0,137,4 (4ct 0st),0.611,2006,2019,LRPL Taylor ,NZ
2332,265,260,135,135,0,5,130,4 (4ct 0st),0.519,2000,2015,Younis Khan ,PAK
2333,280,276,133,133,0,0,133,4 (4ct 0st),0.481,1994,2007,SP Fleming ,NZ
2334,328,324,131,131,0,0,131,3 (3ct 0st),0.4039999999999999,1996,2014,JH Kallis ,SA
2335,350,347,130,130,0,0,130,3 (3ct 0st),0.374,1993,2011,M Muralitharan ,SL
2336,273,270,127,127,0,0,127,3 (3ct 0st),0.47,1979,1994,AR Border ,AUS
2337,398,392,127,127,0,0,127,2 (2ct 0st),0.3229999999999999,1996,2015,Shahid Afridi ,PAK
2338,126,126,126,91,35,91,0,5 (3ct 2st),1.0,1995,2006,Khaled Mashud ,BDESH
2339,330,325,124,123,1,5,118,3 (3ct 0st),0.381,1999,2016,TM Dilshan ,SL
2340,301,294,124,124,0,0,124,3 (3ct 0st),0.421,1999,2019,CH Gayle ,WI
2341,242,240,124,124,0,0,124,3 (3ct 0st),0.516,2008,2019,V Kohli ,INDIA
2342,92,92,124,120,4,120,0,5 (5ct 0st),1.347,1971,1984,RW Marsh ,AUS
2343,445,441,123,123,0,0,123,3 (3ct 0st),0.278,1989,2011,ST Jayasuriya ,SL
2344,227,225,120,120,0,0,120,4 (4ct 0st),0.5329999999999999,1987,2003,CL Hooper ,WI
2345,299,296,120,120,0,0,120,3 (3ct 0st),0.405,1990,2007,BC Lara ,WI
2346,85,83,117,105,12,105,0,4 (4ct 0st),1.409,2008,2017,L Ronchi ,AUS
2347,94,94,117,108,9,108,0,5 (5ct 0st),1.244,2012,2017,MS Wade ,AUS
2348,378,373,113,113,0,0,113,3 (3ct 0st),0.302,1991,2007,Inzamam-ul-Haq ,PAK
2349,325,324,111,111,0,0,111,3 (3ct 0st),0.342,1986,2002,SR Waugh ,AUS
2350,404,397,501,402,99,383,19,5 (4ct 1st),1.261,2000,2015,KC Sangakkara ,SL
2351,287,286,472,417,55,417,0,6 (6ct 0st),1.65,1996,2008,AC Gilchrist ,AUS
2352,350,345,444,321,123,321,0,6 (5ct 1st),1.286,2004,2019,MS Dhoni ,INDIA
2353,295,291,425,403,22,402,1,6 (6ct 0st),1.46,1998,2011,MV Boucher ,SA
2354,219,217,287,214,73,214,0,5 (5ct 0st),1.3219999999999998,1990,2004,Moin Khan ,PAK
2355,260,257,277,262,15,227,35,5 (5ct 0st),1.077,2002,2016,BB McCullum ,NZ
2356,168,168,233,194,39,194,0,4 (4ct 0st),1.386,1988,1997,IA Healy ,AUS
2357,216,215,225,181,44,179,2,5 (5ct 0st),1.046,2006,2019,Mushfiqur Rahim ,BDESH
2358,166,164,220,182,38,182,0,5 (5ct 0st),1.341,1992,2003,Rashid Latif ,PAK
2359,448,443,218,218,0,0,218,4 (4ct 0st),0.492,1998,2015,DPMD Jayawardene ,SL
2360,344,341,210,196,14,72,124,4 (4ct 0st),0.615,1996,2011,R Dravid ,INDIA
2361,189,188,207,132,75,131,1,5 (4ct 1st),1.101,1990,2004,RS Kaluwitharana ,SL
2362,169,168,204,183,21,183,0,4 (4ct 0st),1.214,1981,1991,PJL Dujon ,WI
2363,142,138,202,171,31,171,0,6 (6ct 0st),1.463,2012,2019,JC Buttler ,ENG
2364,147,145,189,160,29,160,0,6 (5ct 1st),1.3030000000000002,1996,2004,RD Jacobs ,WI
2365,157,154,188,157,31,156,1,5 (4ct 1st),1.22,2002,2017,Kamran Akmal ,PAK
2366,139,137,188,181,7,181,0,5 (5ct 0st),1.372,2005,2016,D Ramdin ,WI
2367,228,223,181,176,5,93,83,5 (5ct 0st),0.8109999999999999,2005,2018,AB de Villiers ,SA
2368,126,124,181,170,11,170,0,5 (5ct 0st),1.459,2001,2015,BJ Haddin ,AUS
2369,170,169,174,159,15,148,11,6 (6ct 0st),1.029,1989,2003,AJ Stewart ,ENG
2370,213,212,173,141,32,133,8,5 (5ct 0st),0.816,1992,2003,A Flower ,ZIM
2371,115,111,166,158,8,158,0,6 (5ct 1st),1.495,2013,2019,Q de Kock ,SA
2372,122,121,165,148,17,148,0,5 (5ct 0st),1.3630000000000002,1991,1998,DJ Richardson ,SA
2373,375,372,160,160,0,0,160,3 (3ct 0st),0.43,1995,2012,RT Ponting ,AUS
2374,334,332,156,156,0,0,156,4 (4ct 0st),0.469,1985,2000,M Azharuddin ,INDIA
2375,140,139,154,110,44,110,0,5 (4ct 1st),1.107,1994,2000,NR Mongia ,INDIA
2376,193,193,154,125,29,96,29,5 (5ct 0st),0.797,2004,2019,BRM Taylor ,ZIM
2377,150,150,147,114,33,112,2,4 (4ct 0st),0.98,2001,2012,T Taibu ,ZIM
2378,179,178,141,116,25,111,5,5 (3ct 2st),0.792,1992,2002,AC Parore ,NZ
2379,116,114,140,116,24,116,0,6 (6ct 0st),1.228,2007,2019,Sarfaraz Ahmed ,PAK
2380,463,456,140,140,0,0,140,4 (4ct 0st),0.307,1989,2012,SR Tendulkar ,INDIA
2381,228,224,137,137,0,0,137,4 (4ct 0st),0.611,2006,2019,LRPL Taylor ,NZ
2382,265,260,135,135,0,5,130,4 (4ct 0st),0.519,2000,2015,Younis Khan ,PAK
2383,280,276,133,133,0,0,133,4 (4ct 0st),0.481,1994,2007,SP Fleming ,NZ
2384,328,324,131,131,0,0,131,3 (3ct 0st),0.4039999999999999,1996,2014,JH Kallis ,SA
2385,350,347,130,130,0,0,130,3 (3ct 0st),0.374,1993,2011,M Muralitharan ,SL
2386,273,270,127,127,0,0,127,3 (3ct 0st),0.47,1979,1994,AR Border ,AUS
2387,398,392,127,127,0,0,127,2 (2ct 0st),0.3229999999999999,1996,2015,Shahid Afridi ,PAK
2388,126,126,126,91,35,91,0,5 (3ct 2st),1.0,1995,2006,Khaled Mashud ,BDESH
2389,330,325,124,123,1,5,118,3 (3ct 0st),0.381,1999,2016,TM Dilshan ,SL
2390,301,294,124,124,0,0,124,3 (3ct 0st),0.421,1999,2019,CH Gayle ,WI
2391,242,240,124,124,0,0,124,3 (3ct 0st),0.516,2008,2019,V Kohli ,INDIA
2392,92,92,124,120,4,120,0,5 (5ct 0st),1.347,1971,1984,RW Marsh ,AUS
2393,445,441,123,123,0,0,123,3 (3ct 0st),0.278,1989,2011,ST Jayasuriya ,SL
2394,227,225,120,120,0,0,120,4 (4ct 0st),0.5329999999999999,1987,2003,CL Hooper ,WI
2395,299,296,120,120,0,0,120,3 (3ct 0st),0.405,1990,2007,BC Lara ,WI
2396,85,83,117,105,12,105,0,4 (4ct 0st),1.409,2008,2017,L Ronchi ,AUS
2397,94,94,117,108,9,108,0,5 (5ct 0st),1.244,2012,2017,MS Wade ,AUS
2398,378,373,113,113,0,0,113,3 (3ct 0st),0.302,1991,2007,Inzamam-ul-Haq ,PAK
2399,325,324,111,111,0,0,111,3 (3ct 0st),0.342,1986,2002,SR Waugh ,AUS
2400,404,397,501,402,99,383,19,5 (4ct 1st),1.261,2000,2015,KC Sangakkara ,SL
2401,287,286,472,417,55,417,0,6 (6ct 0st),1.65,1996,2008,AC Gilchrist ,AUS
2402,350,345,444,321,123,321,0,6 (5ct 1st),1.286,2004,2019,MS Dhoni ,INDIA
2403,295,291,425,403,22,402,1,6 (6ct 0st),1.46,1998,2011,MV Boucher ,SA
2404,219,217,287,214,73,214,0,5 (5ct 0st),1.3219999999999998,1990,2004,Moin Khan ,PAK
2405,260,257,277,262,15,227,35,5 (5ct 0st),1.077,2002,2016,BB McCullum ,NZ
2406,168,168,233,194,39,194,0,4 (4ct 0st),1.386,1988,1997,IA Healy ,AUS
2407,216,215,225,181,44,179,2,5 (5ct 0st),1.046,2006,2019,Mushfiqur Rahim ,BDESH
2408,166,164,220,182,38,182,0,5 (5ct 0st),1.341,1992,2003,Rashid Latif ,PAK
2409,448,443,218,218,0,0,218,4 (4ct 0st),0.492,1998,2015,DPMD Jayawardene ,SL
2410,344,341,210,196,14,72,124,4 (4ct 0st),0.615,1996,2011,R Dravid ,INDIA
2411,189,188,207,132,75,131,1,5 (4ct 1st),1.101,1990,2004,RS Kaluwitharana ,SL
2412,169,168,204,183,21,183,0,4 (4ct 0st),1.214,1981,1991,PJL Dujon ,WI
2413,142,138,202,171,31,171,0,6 (6ct 0st),1.463,2012,2019,JC Buttler ,ENG
2414,147,145,189,160,29,160,0,6 (5ct 1st),1.3030000000000002,1996,2004,RD Jacobs ,WI
2415,157,154,188,157,31,156,1,5 (4ct 1st),1.22,2002,2017,Kamran Akmal ,PAK
2416,139,137,188,181,7,181,0,5 (5ct 0st),1.372,2005,2016,D Ramdin ,WI
2417,228,223,181,176,5,93,83,5 (5ct 0st),0.8109999999999999,2005,2018,AB de Villiers ,SA
2418,126,124,181,170,11,170,0,5 (5ct 0st),1.459,2001,2015,BJ Haddin ,AUS
2419,170,169,174,159,15,148,11,6 (6ct 0st),1.029,1989,2003,AJ Stewart ,ENG
2420,213,212,173,141,32,133,8,5 (5ct 0st),0.816,1992,2003,A Flower ,ZIM
2421,115,111,166,158,8,158,0,6 (5ct 1st),1.495,2013,2019,Q de Kock ,SA
2422,122,121,165,148,17,148,0,5 (5ct 0st),1.3630000000000002,1991,1998,DJ Richardson ,SA
2423,375,372,160,160,0,0,160,3 (3ct 0st),0.43,1995,2012,RT Ponting ,AUS
2424,334,332,156,156,0,0,156,4 (4ct 0st),0.469,1985,2000,M Azharuddin ,INDIA
2425,140,139,154,110,44,110,0,5 (4ct 1st),1.107,1994,2000,NR Mongia ,INDIA
2426,193,193,154,125,29,96,29,5 (5ct 0st),0.797,2004,2019,BRM Taylor ,ZIM
2427,150,150,147,114,33,112,2,4 (4ct 0st),0.98,2001,2012,T Taibu ,ZIM
2428,179,178,141,116,25,111,5,5 (3ct 2st),0.792,1992,2002,AC Parore ,NZ
2429,116,114,140,116,24,116,0,6 (6ct 0st),1.228,2007,2019,Sarfaraz Ahmed ,PAK
2430,463,456,140,140,0,0,140,4 (4ct 0st),0.307,1989,2012,SR Tendulkar ,INDIA
2431,228,224,137,137,0,0,137,4 (4ct 0st),0.611,2006,2019,LRPL Taylor ,NZ
2432,265,260,135,135,0,5,130,4 (4ct 0st),0.519,2000,2015,Younis Khan ,PAK
2433,280,276,133,133,0,0,133,4 (4ct 0st),0.481,1994,2007,SP Fleming ,NZ
2434,328,324,131,131,0,0,131,3 (3ct 0st),0.4039999999999999,1996,2014,JH Kallis ,SA
2435,350,347,130,130,0,0,130,3 (3ct 0st),0.374,1993,2011,M Muralitharan ,SL
2436,273,270,127,127,0,0,127,3 (3ct 0st),0.47,1979,1994,AR Border ,AUS
2437,398,392,127,127,0,0,127,2 (2ct 0st),0.3229999999999999,1996,2015,Shahid Afridi ,PAK
2438,126,126,126,91,35,91,0,5 (3ct 2st),1.0,1995,2006,Khaled Mashud ,BDESH
2439,330,325,124,123,1,5,118,3 (3ct 0st),0.381,1999,2016,TM Dilshan ,SL
2440,301,294,124,124,0,0,124,3 (3ct 0st),0.421,1999,2019,CH Gayle ,WI
2441,242,240,124,124,0,0,124,3 (3ct 0st),0.516,2008,2019,V Kohli ,INDIA
2442,92,92,124,120,4,120,0,5 (5ct 0st),1.347,1971,1984,RW Marsh ,AUS
2443,445,441,123,123,0,0,123,3 (3ct 0st),0.278,1989,2011,ST Jayasuriya ,SL
2444,227,225,120,120,0,0,120,4 (4ct 0st),0.5329999999999999,1987,2003,CL Hooper ,WI
2445,299,296,120,120,0,0,120,3 (3ct 0st),0.405,1990,2007,BC Lara ,WI
2446,85,83,117,105,12,105,0,4 (4ct 0st),1.409,2008,2017,L Ronchi ,AUS
2447,94,94,117,108,9,108,0,5 (5ct 0st),1.244,2012,2017,MS Wade ,AUS
2448,378,373,113,113,0,0,113,3 (3ct 0st),0.302,1991,2007,Inzamam-ul-Haq ,PAK
2449,325,324,111,111,0,0,111,3 (3ct 0st),0.342,1986,2002,SR Waugh ,AUS
2450,404,397,501,402,99,383,19,5 (4ct 1st),1.261,2000,2015,KC Sangakkara ,SL
2451,287,286,472,417,55,417,0,6 (6ct 0st),1.65,1996,2008,AC Gilchrist ,AUS
2452,350,345,444,321,123,321,0,6 (5ct 1st),1.286,2004,2019,MS Dhoni ,INDIA
2453,295,291,425,403,22,402,1,6 (6ct 0st),1.46,1998,2011,MV Boucher ,SA
2454,219,217,287,214,73,214,0,5 (5ct 0st),1.3219999999999998,1990,2004,Moin Khan ,PAK
2455,260,257,277,262,15,227,35,5 (5ct 0st),1.077,2002,2016,BB McCullum ,NZ
2456,168,168,233,194,39,194,0,4 (4ct 0st),1.386,1988,1997,IA Healy ,AUS
2457,216,215,225,181,44,179,2,5 (5ct 0st),1.046,2006,2019,Mushfiqur Rahim ,BDESH
2458,166,164,220,182,38,182,0,5 (5ct 0st),1.341,1992,2003,Rashid Latif ,PAK
2459,448,443,218,218,0,0,218,4 (4ct 0st),0.492,1998,2015,DPMD Jayawardene ,SL
2460,344,341,210,196,14,72,124,4 (4ct 0st),0.615,1996,2011,R Dravid ,INDIA
2461,189,188,207,132,75,131,1,5 (4ct 1st),1.101,1990,2004,RS Kaluwitharana ,SL
2462,169,168,204,183,21,183,0,4 (4ct 0st),1.214,1981,1991,PJL Dujon ,WI
2463,142,138,202,171,31,171,0,6 (6ct 0st),1.463,2012,2019,JC Buttler ,ENG
2464,147,145,189,160,29,160,0,6 (5ct 1st),1.3030000000000002,1996,2004,RD Jacobs ,WI
2465,157,154,188,157,31,156,1,5 (4ct 1st),1.22,2002,2017,Kamran Akmal ,PAK
2466,139,137,188,181,7,181,0,5 (5ct 0st),1.372,2005,2016,D Ramdin ,WI
2467,228,223,181,176,5,93,83,5 (5ct 0st),0.8109999999999999,2005,2018,AB de Villiers ,SA
2468,126,124,181,170,11,170,0,5 (5ct 0st),1.459,2001,2015,BJ Haddin ,AUS
2469,170,169,174,159,15,148,11,6 (6ct 0st),1.029,1989,2003,AJ Stewart ,ENG
2470,213,212,173,141,32,133,8,5 (5ct 0st),0.816,1992,2003,A Flower ,ZIM
2471,115,111,166,158,8,158,0,6 (5ct 1st),1.495,2013,2019,Q de Kock ,SA
2472,122,121,165,148,17,148,0,5 (5ct 0st),1.3630000000000002,1991,1998,DJ Richardson ,SA
2473,375,372,160,160,0,0,160,3 (3ct 0st),0.43,1995,2012,RT Ponting ,AUS
2474,334,332,156,156,0,0,156,4 (4ct 0st),0.469,1985,2000,M Azharuddin ,INDIA
2475,140,139,154,110,44,110,0,5 (4ct 1st),1.107,1994,2000,NR Mongia ,INDIA
2476,193,193,154,125,29,96,29,5 (5ct 0st),0.797,2004,2019,BRM Taylor ,ZIM
2477,150,150,147,114,33,112,2,4 (4ct 0st),0.98,2001,2012,T Taibu ,ZIM
2478,179,178,141,116,25,111,5,5 (3ct 2st),0.792,1992,2002,AC Parore ,NZ
2479,116,114,140,116,24,116,0,6 (6ct 0st),1.228,2007,2019,Sarfaraz Ahmed ,PAK
2480,463,456,140,140,0,0,140,4 (4ct 0st),0.307,1989,2012,SR Tendulkar ,INDIA
2481,228,224,137,137,0,0,137,4 (4ct 0st),0.611,2006,2019,LRPL Taylor ,NZ
2482,265,260,135,135,0,5,130,4 (4ct 0st),0.519,2000,2015,Younis Khan ,PAK
2483,280,276,133,133,0,0,133,4 (4ct 0st),0.481,1994,2007,SP Fleming ,NZ
2484,328,324,131,131,0,0,131,3 (3ct 0st),0.4039999999999999,1996,2014,JH Kallis ,SA
2485,350,347,130,130,0,0,130,3 (3ct 0st),0.374,1993,2011,M Muralitharan ,SL
2486,273,270,127,127,0,0,127,3 (3ct 0st),0.47,1979,1994,AR Border ,AUS
2487,398,392,127,127,0,0,127,2 (2ct 0st),0.3229999999999999,1996,2015,Shahid Afridi ,PAK
2488,126,126,126,91,35,91,0,5 (3ct 2st),1.0,1995,2006,Khaled Mashud ,BDESH
2489,330,325,124,123,1,5,118,3 (3ct 0st),0.381,1999,2016,TM Dilshan ,SL
2490,301,294,124,124,0,0,124,3 (3ct 0st),0.421,1999,2019,CH Gayle ,WI
2491,242,240,124,124,0,0,124,3 (3ct 0st),0.516,2008,2019,V Kohli ,INDIA
2492,92,92,124,120,4,120,0,5 (5ct 0st),1.347,1971,1984,RW Marsh ,AUS
2493,445,441,123,123,0,0,123,3 (3ct 0st),0.278,1989,2011,ST Jayasuriya ,SL
2494,227,225,120,120,0,0,120,4 (4ct 0st),0.5329999999999999,1987,2003,CL Hooper ,WI
2495,299,296,120,120,0,0,120,3 (3ct 0st),0.405,1990,2007,BC Lara ,WI
2496,85,83,117,105,12,105,0,4 (4ct 0st),1.409,2008,2017,L Ronchi ,AUS
2497,94,94,117,108,9,108,0,5 (5ct 0st),1.244,2012,2017,MS Wade ,AUS
2498,378,373,113,113,0,0,113,3 (3ct 0st),0.302,1991,2007,Inzamam-ul-Haq ,PAK
2499,325,324,111,111,0,0,111,3 (3ct 0st),0.342,1986,2002,SR Waugh ,AUS
2500,404,397,501,402,99,383,19,5 (4ct 1st),1.261,2000,2015,KC Sangakkara ,SL
2501,287,286,472,417,55,417,0,6 (6ct 0st),1.65,1996,2008,AC Gilchrist ,AUS
2502,350,345,444,321,123,321,0,6 (5ct 1st),1.286,2004,2019,MS Dhoni ,INDIA
2503,295,291,425,403,22,402,1,6 (6ct 0st),1.46,1998,2011,MV Boucher ,SA
2504,219,217,287,214,73,214,0,5 (5ct 0st),1.3219999999999998,1990,2004,Moin Khan ,PAK
2505,260,257,277,262,15,227,35,5 (5ct 0st),1.077,2002,2016,BB McCullum ,NZ
2506,168,168,233,194,39,194,0,4 (4ct 0st),1.386,1988,1997,IA Healy ,AUS
2507,216,215,225,181,44,179,2,5 (5ct 0st),1.046,2006,2019,Mushfiqur Rahim ,BDESH
2508,166,164,220,182,38,182,0,5 (5ct 0st),1.341,1992,2003,Rashid Latif ,PAK
2509,448,443,218,218,0,0,218,4 (4ct 0st),0.492,1998,2015,DPMD Jayawardene ,SL
2510,344,341,210,196,14,72,124,4 (4ct 0st),0.615,1996,2011,R Dravid ,INDIA
2511,189,188,207,132,75,131,1,5 (4ct 1st),1.101,1990,2004,RS Kaluwitharana ,SL
2512,169,168,204,183,21,183,0,4 (4ct 0st),1.214,1981,1991,PJL Dujon ,WI
2513,142,138,202,171,31,171,0,6 (6ct 0st),1.463,2012,2019,JC Buttler ,ENG
2514,147,145,189,160,29,160,0,6 (5ct 1st),1.3030000000000002,1996,2004,RD Jacobs ,WI
2515,157,154,188,157,31,156,1,5 (4ct 1st),1.22,2002,2017,Kamran Akmal ,PAK
2516,139,137,188,181,7,181,0,5 (5ct 0st),1.372,2005,2016,D Ramdin ,WI
2517,228,223,181,176,5,93,83,5 (5ct 0st),0.8109999999999999,2005,2018,AB de Villiers ,SA
2518,126,124,181,170,11,170,0,5 (5ct 0st),1.459,2001,2015,BJ Haddin ,AUS
2519,170,169,174,159,15,148,11,6 (6ct 0st),1.029,1989,2003,AJ Stewart ,ENG
2520,213,212,173,141,32,133,8,5 (5ct 0st),0.816,1992,2003,A Flower ,ZIM
2521,115,111,166,158,8,158,0,6 (5ct 1st),1.495,2013,2019,Q de Kock ,SA
2522,122,121,165,148,17,148,0,5 (5ct 0st),1.3630000000000002,1991,1998,DJ Richardson ,SA
2523,375,372,160,160,0,0,160,3 (3ct 0st),0.43,1995,2012,RT Ponting ,AUS
2524,334,332,156,156,0,0,156,4 (4ct 0st),0.469,1985,2000,M Azharuddin ,INDIA
2525,140,139,154,110,44,110,0,5 (4ct 1st),1.107,1994,2000,NR Mongia ,INDIA
2526,193,193,154,125,29,96,29,5 (5ct 0st),0.797,2004,2019,BRM Taylor ,ZIM
2527,150,150,147,114,33,112,2,4 (4ct 0st),0.98,2001,2012,T Taibu ,ZIM
2528,179,178,141,116,25,111,5,5 (3ct 2st),0.792,1992,2002,AC Parore ,NZ
2529,116,114,140,116,24,116,0,6 (6ct 0st),1.228,2007,2019,Sarfaraz Ahmed ,PAK
2530,463,456,140,140,0,0,140,4 (4ct 0st),0.307,1989,2012,SR Tendulkar ,INDIA
2531,228,224,137,137,0,0,137,4 (4ct 0st),0.611,2006,2019,LRPL Taylor ,NZ
2532,265,260,135,135,0,5,130,4 (4ct 0st),0.519,2000,2015,Younis Khan ,PAK
2533,280,276,133,133,0,0,133,4 (4ct 0st),0.481,1994,2007,SP Fleming ,NZ
2534,328,324,131,131,0,0,131,3 (3ct 0st),0.4039999999999999,1996,2014,JH Kallis ,SA
2535,350,347,130,130,0,0,130,3 (3ct 0st),0.374,1993,2011,M Muralitharan ,SL
2536,273,270,127,127,0,0,127,3 (3ct 0st),0.47,1979,1994,AR Border ,AUS
2537,398,392,127,127,0,0,127,2 (2ct 0st),0.3229999999999999,1996,2015,Shahid Afridi ,PAK
2538,126,126,126,91,35,91,0,5 (3ct 2st),1.0,1995,2006,Khaled Mashud ,BDESH
2539,330,325,124,123,1,5,118,3 (3ct 0st),0.381,1999,2016,TM Dilshan ,SL
2540,301,294,124,124,0,0,124,3 (3ct 0st),0.421,1999,2019,CH Gayle ,WI
2541,242,240,124,124,0,0,124,3 (3ct 0st),0.516,2008,2019,V Kohli ,INDIA
2542,92,92,124,120,4,120,0,5 (5ct 0st),1.347,1971,1984,RW Marsh ,AUS
2543,445,441,123,123,0,0,123,3 (3ct 0st),0.278,1989,2011,ST Jayasuriya ,SL
2544,227,225,120,120,0,0,120,4 (4ct 0st),0.5329999999999999,1987,2003,CL Hooper ,WI
2545,299,296,120,120,0,0,120,3 (3ct 0st),0.405,1990,2007,BC Lara ,WI
2546,85,83,117,105,12,105,0,4 (4ct 0st),1.409,2008,2017,L Ronchi ,AUS
2547,94,94,117,108,9,108,0,5 (5ct 0st),1.244,2012,2017,MS Wade ,AUS
2548,378,373,113,113,0,0,113,3 (3ct 0st),0.302,1991,2007,Inzamam-ul-Haq ,PAK
2549,325,324,111,111,0,0,111,3 (3ct 0st),0.342,1986,2002,SR Waugh ,AUS
2550,404,397,501,402,99,383,19,5 (4ct 1st),1.261,2000,2015,KC Sangakkara ,SL
2551,287,286,472,417,55,417,0,6 (6ct 0st),1.65,1996,2008,AC Gilchrist ,AUS
2552,350,345,444,321,123,321,0,6 (5ct 1st),1.286,2004,2019,MS Dhoni ,INDIA
2553,295,291,425,403,22,402,1,6 (6ct 0st),1.46,1998,2011,MV Boucher ,SA
2554,219,217,287,214,73,214,0,5 (5ct 0st),1.3219999999999998,1990,2004,Moin Khan ,PAK
2555,260,257,277,262,15,227,35,5 (5ct 0st),1.077,2002,2016,BB McCullum ,NZ
2556,168,168,233,194,39,194,0,4 (4ct 0st),1.386,1988,1997,IA Healy ,AUS
2557,216,215,225,181,44,179,2,5 (5ct 0st),1.046,2006,2019,Mushfiqur Rahim ,BDESH
2558,166,164,220,182,38,182,0,5 (5ct 0st),1.341,1992,2003,Rashid Latif ,PAK
2559,448,443,218,218,0,0,218,4 (4ct 0st),0.492,1998,2015,DPMD Jayawardene ,SL
2560,344,341,210,196,14,72,124,4 (4ct 0st),0.615,1996,2011,R Dravid ,INDIA
2561,189,188,207,132,75,131,1,5 (4ct 1st),1.101,1990,2004,RS Kaluwitharana ,SL
2562,169,168,204,183,21,183,0,4 (4ct 0st),1.214,1981,1991,PJL Dujon ,WI
2563,142,138,202,171,31,171,0,6 (6ct 0st),1.463,2012,2019,JC Buttler ,ENG
2564,147,145,189,160,29,160,0,6 (5ct 1st),1.3030000000000002,1996,2004,RD Jacobs ,WI
2565,157,154,188,157,31,156,1,5 (4ct 1st),1.22,2002,2017,Kamran Akmal ,PAK
2566,139,137,188,181,7,181,0,5 (5ct 0st),1.372,2005,2016,D Ramdin ,WI
2567,228,223,181,176,5,93,83,5 (5ct 0st),0.8109999999999999,2005,2018,AB de Villiers ,SA
2568,126,124,181,170,11,170,0,5 (5ct 0st),1.459,2001,2015,BJ Haddin ,AUS
2569,170,169,174,159,15,148,11,6 (6ct 0st),1.029,1989,2003,AJ Stewart ,ENG
2570,213,212,173,141,32,133,8,5 (5ct 0st),0.816,1992,2003,A Flower ,ZIM
2571,115,111,166,158,8,158,0,6 (5ct 1st),1.495,2013,2019,Q de Kock ,SA
2572,122,121,165,148,17,148,0,5 (5ct 0st),1.3630000000000002,1991,1998,DJ Richardson ,SA
2573,375,372,160,160,0,0,160,3 (3ct 0st),0.43,1995,2012,RT Ponting ,AUS
2574,334,332,156,156,0,0,156,4 (4ct 0st),0.469,1985,2000,M Azharuddin ,INDIA
2575,140,139,154,110,44,110,0,5 (4ct 1st),1.107,1994,2000,NR Mongia ,INDIA
2576,193,193,154,125,29,96,29,5 (5ct 0st),0.797,2004,2019,BRM Taylor ,ZIM
2577,150,150,147,114,33,112,2,4 (4ct 0st),0.98,2001,2012,T Taibu ,ZIM
2578,179,178,141,116,25,111,5,5 (3ct 2st),0.792,1992,2002,AC Parore ,NZ
2579,116,114,140,116,24,116,0,6 (6ct 0st),1.228,2007,2019,Sarfaraz Ahmed ,PAK
2580,463,456,140,140,0,0,140,4 (4ct 0st),0.307,1989,2012,SR Tendulkar ,INDIA
2581,228,224,137,137,0,0,137,4 (4ct 0st),0.611,2006,2019,LRPL Taylor ,NZ
2582,265,260,135,135,0,5,130,4 (4ct 0st),0.519,2000,2015,Younis Khan ,PAK
2583,280,276,133,133,0,0,133,4 (4ct 0st),0.481,1994,2007,SP Fleming ,NZ
2584,328,324,131,131,0,0,131,3 (3ct 0st),0.4039999999999999,1996,2014,JH Kallis ,SA
2585,350,347,130,130,0,0,130,3 (3ct 0st),0.374,1993,2011,M Muralitharan ,SL
2586,273,270,127,127,0,0,127,3 (3ct 0st),0.47,1979,1994,AR Border ,AUS
2587,398,392,127,127,0,0,127,2 (2ct 0st),0.3229999999999999,1996,2015,Shahid Afridi ,PAK
2588,126,126,126,91,35,91,0,5 (3ct 2st),1.0,1995,2006,Khaled Mashud ,BDESH
2589,330,325,124,123,1,5,118,3 (3ct 0st),0.381,1999,2016,TM Dilshan ,SL
2590,301,294,124,124,0,0,124,3 (3ct 0st),0.421,1999,2019,CH Gayle ,WI
2591,242,240,124,124,0,0,124,3 (3ct 0st),0.516,2008,2019,V Kohli ,INDIA
2592,92,92,124,120,4,120,0,5 (5ct 0st),1.347,1971,1984,RW Marsh ,AUS
2593,445,441,123,123,0,0,123,3 (3ct 0st),0.278,1989,2011,ST Jayasuriya ,SL
2594,227,225,120,120,0,0,120,4 (4ct 0st),0.5329999999999999,1987,2003,CL Hooper ,WI
2595,299,296,120,120,0,0,120,3 (3ct 0st),0.405,1990,2007,BC Lara ,WI
2596,85,83,117,105,12,105,0,4 (4ct 0st),1.409,2008,2017,L Ronchi ,AUS
2597,94,94,117,108,9,108,0,5 (5ct 0st),1.244,2012,2017,MS Wade ,AUS
2598,378,373,113,113,0,0,113,3 (3ct 0st),0.302,1991,2007,Inzamam-ul-Haq ,PAK
2599,325,324,111,111,0,0,111,3 (3ct 0st),0.342,1986,2002,SR Waugh ,AUS
